9.856736248072522910e-02
9.768317962208619698e-02
1.201707699891323144e-01
9.960704411451633267e-02
9.109277328333029167e-02
8.911096505247630140e-02
1.408578873826907274e-01
1.032120523360880171e-01
1.160024594372281725e-01
1.365268454492951922e-01
1.244504095879025163e-01
8.427088560823065011e-02
1.110009627345089761e-01
1.596825905860616568e-01
7.141020521073816740e-02
1.613791781397034830e-01
1.364113703782025566e-01
1.196024524262891409e-01
1.307856058701872826e-01
1.870285922509188348e-01
1.412894379598303440e-01
1.651733093581592149e-01
1.737168660530677144e-01
1.571718048340139395e-01
1.649314404393617817e-01
1.090797674842178822e-01
1.961550644169059998e-01
2.351161711491071282e-01
1.910650411334175458e-01
1.095395886267607061e-01
1.742758563934610483e-01
2.128225198875252910e-01
1.966601216162626453e-01
1.594443827007825665e-01
1.412267022981093523e-01
2.168276402920197854e-01
2.533160599951560510e-01
1.576183092637130911e-01
1.258777139345721163e-01
9.598017433801522835e-02
1.538602874542658039e-01
1.268367872477168812e-01
1.388662050952776672e-01
1.375848060482754709e-01
1.273978683524406852e-01
1.838304042243040504e-01
1.045992580743936445e-01
9.629195809024028441e-02
1.806876610677976003e-01
1.700819083131276666e-01
1.237151850498496297e-01
1.387038743750263758e-01
2.025997226771253934e-01
2.256036375116449444e-01
1.892850771904564799e-01
2.066806434483554056e-01
1.866400674200401899e-01
1.825141084308807560e-01
1.967060219836779533e-01
1.307754088372278800e-01
1.973627557476552719e-01
1.653612858544175335e-01
1.175927987608772068e-01
1.476357324192157094e-01
1.143725889302843884e-01
1.982199009507894516e-01
1.761536734142842286e-01
9.424507535564211058e-02
1.835270363013618289e-01
1.365685667842626572e-01
1.689998331891659489e-01
2.549684665953883544e-01
1.580408008482593885e-01
2.162516853378082804e-01
1.912620324068344535e-01
1.624236874183854762e-01
1.197800427102125587e-01
1.112249643282176848e-01
1.643819160078867081e-01
1.777726377073962083e-01
1.433438120875507593e-01
1.667559894804771237e-01
1.279792802838178867e-01
1.613589819910255518e-01
1.511362417457768614e-01
2.220943402566123159e-01
1.235418635635421869e-01
2.065937409105782219e-01
1.932873812217552056e-01
1.858140356623782519e-01
1.804030597783052026e-01
1.944377179472492334e-01
1.730267694510985166e-01
1.840948903789887126e-01
1.979946065694093704e-01
2.102633549187045703e-01
2.102099271634450262e-01
1.507195991065460594e-01
2.055857988833360295e-01
2.025632339601333431e-01
2.142141848229444923e-01
