1.531675116409762505e-01
9.628158555670569829e-02
9.220368814959119252e-02
1.348269453691010866e-01
8.480444895282673867e-02
5.248697020579129457e-02
1.144852576544508338e-01
9.882912114978982532e-02
1.238891856046393514e-01
1.086330208390091506e-01
5.858846585481213010e-02
1.617787808494400570e-01
1.188823304568918798e-01
1.861257583189468989e-01
6.842973499666325787e-02
1.367464884488771848e-01
1.944271030191045413e-01
7.452154091935461744e-02
1.508823347103316337e-01
1.239544733499105128e-01
1.745462307993035922e-01
1.023638609510201664e-01
1.430220823878279035e-01
1.213447888742218983e-01
1.259748696421201519e-01
6.599967883756527320e-02
1.636994822810475536e-01
1.484276100079743865e-01
1.352463899037012751e-01
1.936469196628492484e-01
2.054972154146526009e-01
1.138021568409525452e-01
1.729048085936273627e-01
1.655518370680510998e-01
1.457883028197102249e-01
1.889547244287454186e-01
2.084126002513445319e-01
1.301983390563131726e-01
9.838728320140105454e-02
1.001119109300466631e-01
8.016371513636280643e-02
1.120813514795512555e-01
1.341623994566571720e-01
9.093681885860860348e-02
1.140392534210919739e-01
1.417940312889046373e-01
1.086971266911579970e-01
1.179440131840797518e-01
1.603894450057011256e-01
1.474908152057860800e-01
1.037380709536731838e-01
1.630379175409101544e-01
1.767234820335243650e-01
1.739935617034251980e-01
1.549565346481708294e-01
1.870813349064869291e-01
1.877583663847942064e-01
1.384260046940583577e-01
1.744061958519383670e-01
1.335689535077947965e-01
1.867366481142548329e-01
1.375812968740669495e-01
9.297640686138318455e-02
1.908567465411928898e-01
1.203737018020966942e-01
1.547394126761131583e-01
1.579306558347665368e-01
1.678149414678605789e-01
1.745140902124918403e-01
2.159778247497832482e-01
2.512638969346880913e-01
1.495924035373788485e-01
1.757569364719809291e-01
1.547370933461357234e-01
2.228915531259889893e-01
1.089981758178999727e-01
1.470099215467388920e-01
1.064486947770302144e-01
1.446233454446952948e-01
1.694842628561533393e-01
1.394313439870109861e-01
1.643381452349086114e-01
2.013792233281912203e-01
9.597572423109131112e-02
1.827334355419645007e-01
2.328137632531042389e-01
2.427025990954671808e-01
1.898025923695128570e-01
1.695571992134388695e-01
1.721297683050999339e-01
1.483708030830782065e-01
1.679626852766467338e-01
1.567044621333479881e-01
1.903631188190327284e-01
1.903816295357850796e-01
1.813339264347003099e-01
1.742337830364704132e-01
1.472838838369800452e-01
1.756181043501083561e-01
1.754694275128153569e-01
1.977525526084578933e-01
