1.603319942951202393e-01
1.525788167491555214e-01
1.576473386958241463e-01
1.614031996577978134e-01
9.443736542016267776e-02
1.249131318181753159e-01
1.436559408903121948e-01
1.528072291985154152e-01
1.193018619503293659e-01
1.142969642366681721e-01
1.343821074281419947e-01
1.542055500405175306e-01
1.651897653937339783e-01
1.503831243940762230e-01
1.527690440416336060e-01
1.639208878789629176e-01
