7.605109957876265980e-02
9.503864031285047531e-02
2.324210481185998156e-01
1.481930973981694100e-01
3.108671255176886916e-02
1.079976544715464115e-01
8.823511051014065742e-02
2.345401218294032933e-02
1.845428820815868676e-01
1.433723845984786749e-01
2.411826225995485351e-01
1.022965365804598820e-01
1.343173196873976849e-01
1.326648951471725013e-01
1.819156438744227722e-01
1.166272958674069021e-01
