1.085107632291813645e-01
1.297434029560966817e-01
1.050435769791257801e-01
1.002273128833621740e-01
3.592545583835869694e-02
1.011963634066757739e-01
1.046902937814593315e-01
7.775960937007246609e-02
6.315708501538860875e-02
9.599291712428177636e-02
1.256211907821125351e-01
1.195230482070266109e-01
7.861407117369319242e-02
1.236052575487909533e-01
7.711635300898121714e-02
1.049545603195188720e-01
