1.134377277589270067e-01
1.948455568136913396e-01
1.024666456505656242e-01
1.881842939848346330e-01
1.502856868325709843e-03
2.039738101955208549e-01
1.258111964012381956e-01
2.485030262420574731e-01
1.973865665131597780e-01
9.856835534862641579e-02
2.322801593303059631e-01
1.599423511485968397e-01
2.397006433457136154e-01
1.605363286410768919e-01
1.811588054156995364e-01
1.694234756675238318e-01
