1.260585379428588448e-01
1.404375971223299213e-01
1.092144452581683550e-01
1.504712731330073439e-01
1.123741967603564262e-01
8.705409329671126573e-02
1.138473957275541876e-01
1.409295536219500600e-01
9.052386457243791207e-02
1.297397912981418377e-01
8.548555139882060838e-02
1.230114522891549017e-01
1.310098414810804135e-01
1.894462590034191318e-01
1.133676847586264913e-01
1.397003778323638590e-01
1.740277630384438334e-01
1.529038949654652479e-01
1.193322509240645618e-01
1.226849172694178675e-01
1.601260146842553023e-01
1.207921188324689865e-01
1.274035086568731656e-01
1.409174281244094662e-01
1.404163222759962082e-01
1.678519733250141144e-01
2.076258224506790928e-01
1.690802346700086001e-01
2.318029325240506533e-01
1.703590150349415244e-01
1.792538445442914963e-01
2.331577900510568013e-01
2.320899970542926183e-01
1.515611089192903937e-01
2.256520669907331467e-01
1.949499388440297243e-01
1.764906621896303596e-01
1.240637104671735019e-01
1.633467669240557252e-01
1.779389134966410102e-01
1.730793812133085141e-01
1.644997861585579813e-01
1.263770920654329055e-01
1.184255594181684856e-01
1.934231188721381722e-01
1.844875504477666017e-01
1.906647812575101852e-01
1.792582432524515990e-01
2.730411574817620535e-01
2.266093213827564123e-01
1.879409985939184125e-01
2.346937109071474681e-01
1.939868694887711409e-01
2.271222143183247444e-01
2.003154218411789533e-01
2.311348509437476106e-01
2.469277264407047923e-01
1.887755755048531880e-01
1.876029071326439090e-01
1.564406471577687863e-01
2.593003590233050604e-01
2.090622158004687425e-01
2.363773146644234657e-01
2.194644538685679436e-01
2.663272446594558973e-01
2.809068264009860760e-01
2.034824705467774275e-01
1.867649601414226590e-01
2.650766188565354953e-01
2.486939981463365257e-01
1.956506979006987224e-01
1.472807152626606220e-01
1.994186890884660779e-01
2.118394947968996467e-01
2.423774128636488612e-01
1.556805045021554534e-01
2.312124312067261045e-01
1.685614489878599354e-01
2.080315211071417925e-01
2.027792231394694444e-01
2.384961763969980775e-01
1.838516694708512422e-01
2.458715139028544716e-01
1.759938973790177996e-01
3.298518693504425281e-01
2.498597121582581404e-01
1.933977149713497767e-01
2.290501762897922400e-01
2.199581256852700117e-01
1.989334492693440315e-01
2.053441970895689139e-01
2.537691590483658333e-01
1.944637466222047806e-01
2.442051496070165029e-01
2.027640404322972600e-01
2.543862462043762207e-01
2.692140339372249835e-01
2.381429452305802996e-01
2.408181345806671980e-01
2.905433216633704907e-01
2.863775411477455513e-01
