1.234166100621223450e-01
1.869454253464937210e-01
1.302289431914687157e-01
1.270093983039259911e-01
1.023702840320765972e-01
1.296457098796963692e-01
1.215599374845623970e-01
1.211550408042967319e-01
9.404911872531686312e-02
1.008965367717402362e-01
1.119010943387235973e-01
1.245912398610796307e-01
1.309615756784166529e-01
1.184700690209865570e-01
1.242329957229750537e-01
1.320409008434840492e-01
