1.404016257147304714e-01
1.359289785614237189e-01
1.298308046534657478e-01
1.469290855457074940e-01
3.773065363930072635e-03
5.855398921994492412e-02
1.486317624512594193e-01
1.270687024807557464e-01
1.015952552136565983e-02
6.850634445436298847e-02
9.103805750575182099e-02
1.015290165586130999e-01
8.135344001597591412e-02
1.148635857472462274e-01
1.249401725362986326e-01
1.445427036711147972e-01
