1.855911966723700346e-01
5.709251970152503380e-02
9.770082301318845641e-02
1.261606415459287367e-01
1.460912553011439741e-01
1.756741652976156198e-01
1.956549140200617709e-01
1.268074600624718717e-01
1.718667347907155141e-01
2.168330686732328483e-01
1.702234712782748349e-01
1.341954724380879649e-01
1.429804327136870168e-01
1.984000133899306573e-01
1.805640174840976164e-01
1.868614909970866822e-01
