8.233870200598951417e-02
9.588430604031597526e-02
4.106044094514892974e-03
4.105901886086867417e-03
8.619948101875932189e-02
1.240739583205180546e-01
1.172469025479118410e-01
4.861849945322113675e-02
7.545489546717031037e-02
8.064811529677003155e-02
1.221441809827560898e-01
8.390227211674490537e-02
1.155681879243254662e-01
1.403060167826529758e-01
3.996759913928402130e-02
4.564939652695128997e-02
7.413807180349802489e-03
7.773293685134446962e-02
1.058555184395635895e-01
1.063618584835838710e-01
1.424127150865739100e-01
1.522668632919354226e-01
2.595302195104873810e-01
2.004145873440336678e-01
1.726389227430625006e-01
1.686958851549101857e-01
8.341374275387035409e-02
8.410253658689288703e-02
1.166559643431679255e-01
1.576293720800750753e-01
1.367119858251439335e-01
1.235211831584680231e-01
1.812695941604873240e-01
1.575456721505300028e-01
1.744177484724087346e-01
1.502597358930870541e-01
1.808754343390039376e-01
9.536494893044042409e-02
1.463786517150166555e-01
2.083459309941592674e-01
1.276800379434742116e-01
6.180611349079229849e-02
8.634906856021593025e-02
1.271323357889636574e-01
1.159315624230517761e-01
6.625403621602835025e-02
1.028610994776674725e-01
1.366756067297081600e-01
7.639805717378322925e-03
8.350557012347245567e-02
1.326848323035917029e-02
1.176763359278013982e-01
3.355132382558029258e-02
8.687278279811476434e-02
6.987730700754687940e-02
1.759673266472488451e-01
2.587233848394834279e-01
1.022700747230767537e-01
9.578506669846284516e-02
8.199576695401643300e-02
1.982568285071161646e-02
7.240070338733174682e-02
7.729715415024375480e-02
5.659984782521408631e-02
6.196594243369153016e-02
2.362296788958509128e-02
1.251883937383301837e-01
1.965615109347747524e-01
1.487373755120303120e-01
1.273904163808393664e-01
1.922542423461816863e-01
1.642657418890044463e-01
1.020234641413690774e-01
1.591587878335233852e-01
1.973465670964217877e-01
1.357405657588580672e-01
1.515569128759867989e-01
1.366748144664231834e-01
1.649440144918536688e-01
2.232118707270569213e-01
1.906793642692467539e-01
6.485619983144855216e-02
1.018840236109833375e-01
5.567158328877287732e-02
4.652478118639949423e-02
2.266264843512541885e-02
1.013846434976881095e-01
9.329543503811302263e-02
1.249554836424473514e-01
3.543993914806137929e-02
6.574072144139678220e-02
1.159513725089027503e-01
1.348411895155462725e-01
1.012124451678153847e-01
1.652449461784132045e-01
1.313885311323107208e-01
1.077025661020540037e-01
1.608933466548198576e-01
1.052324901561471210e-01
1.153746019233494735e-01
1.474665505330064463e-01
