3.274211389323075649e-01
1.982742281231497095e-01
1.793526139642511175e-01
1.972947962848203562e-01
1.066509242103036020e-01
1.955501854951892660e-01
2.476089092503701017e-01
2.274390505294182352e-01
1.549104722383032873e-01
3.065350110243473813e-01
3.084316456723691924e-01
1.799828408152929493e-01
1.569680377932465010e-01
1.891834650388253547e-01
1.556687760582592950e-01
2.244272681751421639e-01
