1.700289006873693665e-01
1.445245076455340116e-01
1.258281671586181372e-01
8.447398204953060485e-02
4.807489913270858450e-02
1.306025190746627762e-01
1.203963371748873884e-01
1.409912730326011165e-01
1.383841050675828632e-01
1.312418794820717216e-01
1.612082274399913862e-01
1.323714885828459475e-01
1.587398842020775191e-01
1.829275510899849855e-01
1.517767108143128485e-01
1.502688578130053909e-01
