1.872247583543260874e-01
1.029772915894032609e-01
1.838331402084025235e-01
2.077312548727994479e-01
7.676782762947757799e-02
1.464628471232052587e-01
1.564642173387775503e-01
2.228507591311686686e-01
1.669952067812638663e-01
2.102431700332090259e-01
2.379476256402475454e-01
1.710371340491942116e-01
1.725256966185822471e-01
1.520416698934111133e-01
1.817062102158420733e-01
1.838208158234400369e-01
