1.457480924436822534e-01
1.706218145113130580e-01
2.236784533852187451e-01
2.002791588560544900e-01
3.598865412641316652e-02
1.505225805158261210e-01
1.690725250435727023e-01
1.717278471915051341e-01
1.184272666814649710e-01
1.624812539666891098e-01
2.179345319163985550e-01
2.553366529090063675e-01
1.278557480712022021e-01
1.352177373155427631e-01
1.792683212884834953e-01
1.381085145567340078e-01
