1.916745868153297006e-01
1.911206145126085887e-01
nan
1.661324808015846310e-01
1.831374686802379192e-01
1.911799682734104389e-01
1.715930696003712119e-01
1.810897471239933665e-01
1.868471100639838567e-01
1.904083636517708011e-01
1.864909826276394123e-01
1.827813455691704447e-01
1.872032352078419337e-01
1.901709468891987498e-01
1.679131117864297029e-01
1.715930696003712119e-01
1.213793932513978630e-01
1.571996714919805527e-01
nan
1.566951575760658077e-01
1.572887024197440753e-01
1.630609022596707647e-01
1.661918386816978455e-01
1.654499078599306339e-01
1.626751000204911535e-01
1.646189514117745167e-01
1.663773207423778766e-01
1.864909826276394123e-01
1.597815780685498122e-01
1.594254558619398465e-01
1.747907799883530733e-01
1.654499078599306339e-01
1.682098790143544964e-01
1.720085503676762884e-01
1.746201365469740030e-01
1.752136782384835778e-01
1.728840255393431780e-01
1.746201365469740030e-01
1.760149612449682655e-01
1.661324808015846310e-01
1.810897471239933665e-01
1.827813455691704447e-01
1.916745868153297006e-01
1.831374686802379192e-01
1.868471100639838567e-01
1.872032352078419337e-01
1.911206145126085887e-01
1.911799682734104389e-01
1.904083636517708011e-01
1.901709468891987498e-01
1.575854714386738242e-01
1.578674042740693395e-01
1.213793932513978630e-01
1.575854714386738242e-01
1.602564118802547455e-01
1.602564123817361297e-01
1.597815780685498122e-01
1.578674042740693395e-01
1.602564123817361297e-01
1.616809133153695455e-01
1.656576497480273247e-01
1.572887024197440753e-01
1.527777801339443020e-01
1.669337656348943710e-01
1.679724643293481479e-01
1.682098790143544964e-01
1.653608791530132294e-01
1.677350475667760965e-01
1.689814862150412211e-01
1.626751000204911535e-01
1.653608791530132294e-01
1.671415037260605696e-01
1.740661638860519222e-01
1.728840255393431780e-01
1.705840493624027066e-01
1.722756447986914519e-01
1.738782086624549028e-01
1.571996714919805527e-01
1.630609022596707647e-01
1.646189514117745167e-01
1.679131117864297029e-01
nan
1.661918386816978455e-01
1.663773207423778766e-01
1.669337656348943710e-01
1.677350475667760965e-01
1.594254558619398465e-01
1.656576497480273247e-01
1.679724643293481479e-01
1.689814862150412211e-01
1.723646756548147807e-01
1.720085503676762884e-01
1.671415037260605696e-01
1.723646756548147807e-01
1.733143432782246474e-01
1.746201365469740030e-01
1.722756447986914519e-01
nan
1.764601176747908895e-01
1.747907799883530733e-01
1.746201365469740030e-01
1.760149612449682655e-01
1.740661638860519222e-01
1.738782086624549028e-01
1.764601176747908895e-01
