2.292770868788162886e-01
1.334771635509761356e-01
1.219729117583483458e-01
1.662625494146985627e-01
1.100367517423624791e-01
2.233463502177203686e-01
2.473556640075652846e-01
2.077785847879048131e-01
1.457967763583707943e-01
2.302539488300681114e-01
2.503547912762899563e-01
2.243182541403387353e-01
1.670612635623131559e-01
1.898702471163622729e-01
1.500885935061627985e-01
1.776809319188552283e-01
