1.382735777805010058e-01
5.550178744145919246e-02
1.207271865359877960e-01
1.456014805667434353e-01
1.179864924021753053e-01
4.831035749418788328e-02
6.778368477463507513e-02
1.755721693678416184e-01
1.281915281308191046e-01
8.625021417655277800e-02
9.653114541703752827e-02
1.417782056301868099e-01
1.510511618984049786e-01
1.057911311050563491e-01
1.143145945482615389e-01
1.507566158376302534e-01
