5.893820139945755293e-02
6.397280720012840562e-04
4.719179202173125892e-02
1.093855818166531435e-01
1.375276909441538464e-01
1.426461135231801014e-01
1.485775217661051417e-01
1.569259987316894145e-01
1.677604824190989385e-01
1.731523930071980633e-01
1.189666345987662605e-01
1.020706970477526093e-01
1.751227392325140630e-01
1.280334851651971917e-01
1.622147914449385553e-01
1.577502285194764264e-01
