1.229284589107220022e-01
1.226100921630859375e-01
nan
8.966792432161477255e-02
1.108201711366956083e-01
1.210743739054753187e-01
9.621241000982430625e-02
1.008936625260573178e-01
1.124753080881558953e-01
1.197658868936391924e-01
1.167560953360337467e-01
1.131783402883089484e-01
1.163497062829824541e-01
1.204979969904972914e-01
1.642915468949537883e-01
9.621241000982430625e-02
1.018863569658536167e-01
1.464933059536493720e-01
nan
1.425270484044001695e-01
1.378440260887145996e-01
1.490476268988389363e-01
1.584337766353900723e-01
1.586896823002741930e-01
1.539099399860088535e-01
1.558999052414527242e-01
1.601360027606670566e-01
1.167560953360337467e-01
1.330575942993164062e-01
1.518434102718646816e-01
1.746539519383357164e-01
1.586896823002741930e-01
1.558570770116952664e-01
1.634956506582406766e-01
1.726143910334660414e-01
1.751225636555598375e-01
1.706646818381089559e-01
1.719825451190654941e-01
1.757919604961688809e-01
8.966792432161477255e-02
1.008936625260573178e-01
1.131783402883089484e-01
1.229284589107220022e-01
1.108201711366956083e-01
1.124753080881558953e-01
1.163497062829824541e-01
1.226100921630859375e-01
1.210743739054753187e-01
1.197658868936391924e-01
1.204979969904972914e-01
1.275731875346257094e-01
1.317871442207923238e-01
1.018863569658536167e-01
1.275731875346257094e-01
1.306743071629450914e-01
1.339890406681941148e-01
1.330575942993164062e-01
1.317871442207923238e-01
1.339890406681941148e-01
1.365258143498347398e-01
1.567985277909498820e-01
1.378440260887145996e-01
1.296004698826716539e-01
1.521934454257671543e-01
1.566636791596045797e-01
1.558570770116952664e-01
1.509650853963998562e-01
1.542664491213285027e-01
1.581673988929161723e-01
1.539099399860088535e-01
1.509650853963998562e-01
1.574180283798621294e-01
1.723545927267808309e-01
1.706646818381089559e-01
1.661629493419940762e-01
1.675206560354966512e-01
1.720675688523512492e-01
1.464933059536493720e-01
1.490476268988389363e-01
1.558999052414527242e-01
1.642915468949537883e-01
nan
1.584337766353900723e-01
1.601360027606670566e-01
1.521934454257671543e-01
1.542664491213285027e-01
1.518434102718646816e-01
1.567985277909498820e-01
1.566636791596045797e-01
1.581673988929161723e-01
1.650992586062504652e-01
1.634956506582406766e-01
1.574180283798621294e-01
1.650992586062504652e-01
1.666413820706880988e-01
1.719825451190654941e-01
1.675206560354966512e-01
nan
1.759394132173978387e-01
1.746539519383357164e-01
1.726143910334660414e-01
1.757919604961688809e-01
1.723545927267808309e-01
1.720675688523512492e-01
1.759394132173978387e-01
