2.107843356207013130e-01
1.210095208911557835e-01
1.857495642366952249e-01
1.942345480035458372e-01
1.194502261600324106e-01
1.717692844436637112e-01
1.562737009288477086e-01
1.813322378043916994e-01
1.770378665200301460e-01
1.551588707869606398e-01
1.560000489449261674e-01
1.850739710831216522e-01
1.742370549057211115e-01
1.708065431032861903e-01
1.846765898517332971e-01
1.741464229167572209e-01
