1.018364302939377131e-01
1.137620613131170716e-01
1.129267218683917967e-01
1.106120645552157167e-01
1.010471768677234650e-01
7.859266347860774382e-02
1.175095748442869931e-01
1.794046265332816248e-01
1.136477807393440898e-01
1.155226045459410433e-01
1.045409504166365522e-01
1.354782481112474235e-01
1.026725916402798366e-01
1.120763067872478369e-01
2.530531726307135021e-02
1.335513980906958276e-01
1.088811171670945738e-01
8.268626232277781485e-02
9.851709419252493993e-02
1.892177383728826934e-01
1.287613685171191402e-01
9.035665089770471281e-02
1.450438522525263896e-01
1.689125257096468213e-01
1.310578864241296604e-01
5.623328295713200808e-02
1.334758177399635315e-01
1.693985360817840402e-01
1.260009601895804854e-01
1.036478508534715848e-01
1.468361466048428710e-01
1.903115949020362796e-01
1.839411892444611785e-01
1.073114511986764524e-01
1.477078782896009690e-01
1.379015654540405866e-01
1.619673192572708420e-01
5.807997135941123795e-02
4.205656306742010242e-02
4.020900814794003963e-02
6.341962712422873072e-02
4.488555272223056225e-02
2.773348207752016764e-02
4.070030603235444411e-02
3.456656812005139134e-02
4.820148892646942268e-02
3.387601127346547697e-02
3.079515805718703939e-02
9.757735144991713794e-02
1.575048361331797542e-01
5.817111181462363695e-02
9.034068274866932646e-02
1.214222709655027460e-01
1.429955052355161016e-01
1.560915766391330062e-01
1.291863473777014604e-01
1.106046293906939176e-01
1.285541861926993434e-01
1.724493276471128766e-01
7.749869509447868121e-02
9.635056321097251741e-02
1.170526245969785301e-01
1.627526609585262241e-01
1.288339630522946644e-01
1.654254781046452516e-01
1.061126754637091163e-01
1.503260671519316138e-01
1.143833493384031202e-01
1.452322103566704992e-01
1.224466210125963461e-01
1.341462800753386309e-01
1.537639275193214417e-01
1.074332600916162728e-01
1.437070671594343485e-01
9.514336990049251930e-02
6.553216679307191650e-02
6.889478946212299060e-02
1.005574853535598223e-01
7.452723456439204475e-02
7.762916177475395751e-02
1.076569872732140304e-01
1.343597126923179175e-01
1.285520763972621827e-01
1.334667288493409931e-01
1.491854299719516941e-01
1.474811247767670030e-01
1.034556183865508738e-01
1.609351884287137380e-01
1.090928903028655500e-01
1.383143473567160497e-01
1.458571297877754858e-01
1.081248649548237767e-01
1.507541945354135549e-01
1.315937171054359367e-01
1.620586737273977396e-01
1.227223603690128229e-01
6.543206603796883347e-02
1.160435463086916807e-01
1.235580308096429630e-01
1.457040199401000435e-01
1.584301167122948162e-01
