6.610342425771985331e-02
9.967267204326792085e-02
1.245292892694771225e-01
1.240651178853183351e-01
1.147484284861443188e-01
6.811387757583754754e-02
9.716700045382034578e-02
1.103085379458766807e-01
1.112431926840844604e-01
6.747465685475617647e-02
1.073838019191708376e-01
1.251474588671744048e-01
1.094031157142755784e-01
1.027420558513348070e-01
4.861518009777686389e-02
1.032457171814940011e-01
6.170633061824796345e-02
7.807158625384474915e-02
1.010173615202522579e-01
1.272471914685761041e-01
1.563773038259778925e-01
9.095340980967683842e-02
1.177075526524836574e-01
2.066108571463980970e-01
1.020292044594506009e-01
6.869295088110159708e-02
1.091520181541384832e-01
1.822011539816930370e-01
1.369970870490970494e-01
8.772513578420469693e-02
1.449768813805488998e-01
1.271705370395815882e-01
1.417645393297649326e-01
1.056551475826731507e-01
1.227081100760887417e-01
2.036727397801139650e-01
9.998057751844796615e-02
2.711385653008712565e-02
9.561249198923003900e-02
1.653265015654771866e-02
7.049852838980978642e-02
7.226567690745183681e-02
3.409474460848006816e-02
6.774442672674642341e-02
3.541220800765096377e-02
5.452633799331334241e-02
6.576420785987781292e-02
2.468550591925122717e-02
1.326409141922620383e-01
1.759132696097367443e-01
2.921454371630182942e-02
1.209149662225592337e-01
1.132495118799852207e-01
7.239861521181339965e-02
7.371398140318118075e-02
9.595725037238131416e-02
1.811280653480655256e-01
1.231774633878768149e-01
1.672841600285699670e-01
1.842170810985128138e-01
1.201512086356440467e-01
1.524540702140746717e-01
2.167591299660741044e-01
1.328230343519513079e-01
1.301658699071595038e-01
1.599074894225613330e-01
2.004760817032302522e-01
1.433533236805278055e-01
1.392841123667424852e-01
1.692274398712750316e-01
2.015367387973058810e-01
1.075015667906532441e-01
1.741175141029928652e-01
1.302754450824487875e-01
1.012934231929158713e-01
1.046007032627769423e-01
7.363287587381470156e-02
8.586055833438877016e-02
9.376799857757479872e-02
9.585717679731085850e-02
7.315536227849861461e-02
1.711546161050836734e-01
1.711487501238305176e-01
6.372450198996393311e-02
1.839377074188982553e-01
1.450673722308429836e-01
1.724711777709531935e-01
1.234175248462004437e-01
1.091626311221996493e-01
1.171749565871310766e-01
1.466294676037043776e-01
1.428458303192970680e-01
7.079833445067588993e-02
1.869656386339696719e-01
1.044631885230885987e-01
1.474261759054623089e-01
1.196513228261699979e-01
1.045997856130830156e-01
1.408610928310036481e-01
1.532750767638879907e-01
1.299387394772985871e-01
