1.564347749047625968e-01
1.631917406146105587e-01
1.327305384284745149e-01
1.507329370202009633e-01
1.884080698588289915e-01
9.594977103662270801e-02
1.265724618565662596e-01
2.011818123999266628e-01
9.624813792029621173e-02
8.775686317908192036e-02
1.043441687316562089e-01
1.715923719412575654e-01
1.670889872475527227e-01
1.180153065555221981e-01
3.215144980206856989e-02
1.242638046194840112e-01
1.697158748306369924e-01
7.558618294035568397e-02
1.622882141897347419e-01
2.122074876141805955e-01
9.578188773817740420e-02
2.205644242270724253e-01
1.652854402686198820e-01
1.172287337517795708e-01
1.342883022555794725e-01
5.003374263805408784e-02
1.903060800127255314e-01
1.159483446601300843e-01
1.631882312492682341e-01
7.507789593476515977e-02
1.211028292380853244e-01
2.799099669075356123e-01
1.645693426566700035e-01
1.076377961032379121e-01
2.029210264356645088e-01
1.886519045107188930e-01
2.024768187055507596e-01
6.091824717510208737e-02
3.859417801364683348e-02
1.262479328722223015e-01
8.759977163460391791e-02
3.370098656423928946e-02
6.933401194561748804e-02
5.390990556408122025e-02
6.594032824626790135e-02
7.968394636061650049e-02
1.261381912200144617e-01
4.262896559928846391e-02
1.786832378532450805e-01
1.671212116220536226e-01
6.760348811826588644e-02
2.400637133261905309e-01
1.623357723449141976e-01
1.727002219189531507e-01
1.196062306703862127e-01
1.743176471332285038e-01
1.348204908035068594e-01
1.806127608467180123e-01
1.745304173332092867e-01
1.466396593910198609e-01
1.674821462539652084e-01
2.755765477062456226e-01
2.120806525518464103e-01
1.486355596176648641e-01
1.171740204668962060e-01
1.854522439064636985e-01
1.531223970657895062e-01
1.173292444421419473e-01
1.684033901868848271e-01
1.636314036891585166e-01
1.363098308211192489e-01
1.272754146716732204e-01
1.441559807683985839e-01
1.456954301104885219e-01
1.770602699297551819e-01
8.517090238176304451e-02
1.541381720047026449e-01
1.398226652214785981e-01
1.538976434258949311e-01
1.027313973015854809e-01
1.315547138040598640e-01
1.720629193497678344e-01
2.058320160274608734e-01
1.213149930518397923e-01
1.476497893860281574e-01
2.235153054084199065e-01
1.353711506879055615e-01
1.673430993911237119e-01
1.488889650656626817e-01
1.895846077262478280e-01
1.106012478144993288e-01
1.751300601933438172e-01
1.479156037330540130e-01
2.037979655257144140e-01
1.794231884876773264e-01
2.637805196393925855e-01
9.763970064534834015e-02
1.638768321925873905e-01
1.314780527743725780e-01
1.755972435303892187e-01
2.059854402994880374e-01
