1.764758660642352650e-01
1.893776227620297126e-01
2.199166818203853457e-01
1.877026074424585633e-01
7.514835491268253599e-03
7.233521813883012075e-02
1.125830999844765756e-01
1.773026648801792893e-01
1.830610533947947260e-01
2.282414411466951176e-01
1.826836956658683397e-01
1.540959623744129203e-01
2.087787680284236558e-01
1.784308946049090461e-01
1.673037209600027331e-01
1.820219061430959351e-01
