1.972389606230232628e-01
2.606654280039850113e-01
1.873670254310176031e-01
2.049470942656625994e-01
1.295693684798087351e-02
2.460557008590253114e-01
2.352399812030593618e-01
1.867120850249323616e-01
7.249374653370718735e-02
1.308337177246617633e-01
1.761784651628529041e-01
1.698339492876194956e-01
1.465305864643369205e-01
1.994527370897490604e-01
2.100328692727738977e-01
1.720873846820073216e-01
