4.806348713687979418e-02
2.715408567410822205e-02
2.316089013877969602e-02
3.832899416067028775e-02
1.908571453979955243e-02
4.437519557317360502e-02
8.828091021412266814e-02
4.215693944066655624e-02
9.005603516617646798e-02
9.041525196069134795e-02
6.557738663440641769e-02
3.986227343109650934e-02
4.025809167741009609e-02
7.916635814427326612e-02
1.202770245906252117e-01
5.935513312719054718e-02
1.050557361629146785e-01
9.086435776239690232e-02
1.184993497131822254e-01
1.024951923788578884e-01
1.394776370434556156e-01
1.032612254628195170e-01
1.127038935306840239e-01
1.073791437710707036e-01
1.250823190292486842e-01
1.524287969939625564e-01
1.020370023056434844e-01
1.090802833787165582e-01
1.906430157653700719e-01
1.790301077909624283e-01
1.660025568249133832e-01
1.600753358708551233e-01
1.594410631447457372e-01
1.017606107947918032e-01
1.579337187487488692e-01
1.865035594584276979e-01
1.472005625065111734e-01
1.271530693361105913e-01
1.516001525496204205e-01
1.559174431380457582e-01
1.408675434067845345e-01
1.679166680302072445e-01
1.732882052959981711e-01
1.551482585222961896e-01
1.786751061355551784e-01
1.781707664038269523e-01
1.992172219324856997e-01
1.395374645004407166e-01
1.067075159293241204e-01
1.172441638146455439e-01
1.299492595717310905e-01
1.165223464083213062e-01
1.551337966408867231e-01
1.769453024384207429e-01
1.278338215421312152e-01
1.866972396696487957e-01
1.386884162381578078e-01
1.535942238898804491e-01
1.244489707871532791e-01
1.510824465121214100e-01
1.662761735855243506e-01
1.151074775731943250e-01
1.600838333654862056e-01
1.555782474147585637e-01
1.371954193589492443e-01
1.303657089861539609e-01
1.665308411197307104e-01
1.661558613649014304e-01
1.900414371316750950e-01
1.829844928064491005e-01
1.422057037617867892e-01
1.895459710906904349e-01
1.774885919876396656e-01
1.982247090289512570e-01
1.912060266253180207e-01
2.016141658980184492e-01
2.122521471733657128e-01
1.845016761754567913e-01
2.203091741181336938e-01
2.219264560273866427e-01
1.750527730372805901e-01
2.161694458829095666e-01
2.298269683960825205e-01
2.264123457269026640e-01
1.772844832784567781e-01
1.955134400005380801e-01
1.784987142309546471e-01
1.971957568580714470e-01
1.371282645178815429e-01
2.331379631247658124e-01
2.233462918979617351e-01
2.120576002993262710e-01
1.919785145168694251e-01
2.002564070459741941e-01
2.062611054055965842e-01
1.780741987839484508e-01
1.418455733129611318e-01
1.943313298890223806e-01
2.243390775178200902e-01
2.053351984001123010e-01
1.850394866285988982e-01
