1.408471726125544166e-01
1.418721718236367890e-01
1.396500031110635143e-01
1.432781021129953536e-01
1.433517703360768780e-01
6.638490945328145987e-02
1.373169558477030372e-01
1.460216137986745100e-01
1.410761773392063267e-01
1.115924098396053610e-01
1.418248074024936189e-01
1.436040866692299411e-01
1.430763348493366005e-01
1.380297095222266512e-01
6.660092616742266250e-04
1.355898905908850260e-01
1.395318023733954083e-01
6.593382137156560130e-02
1.367927910140928627e-01
1.414728605065024847e-01
1.377378285185755780e-01
1.088484424368510589e-01
1.382234099385843684e-01
1.392960623731977488e-01
1.377111031633890259e-01
5.996223129407144250e-04
1.393185015709995644e-01
1.425911047642298979e-01
1.336388752383780854e-01
6.648582125087815209e-02
1.362061787259099543e-01
1.443265584656887868e-01
1.318252694434910444e-01
1.119253418294119673e-01
1.383623503718219572e-01
1.419777116376419734e-01
1.417236738890260694e-01
6.724736988520558254e-05
3.908560999113663706e-04
6.010226232841712297e-04
3.947088962835730379e-04
3.997100932094249399e-04
6.717352683549731359e-04
1.540573271506180978e-03
2.540830239967725593e-04
5.765313196410116027e-04
3.976443885326167273e-04
4.182278031407992195e-04
1.399995615631563772e-01
1.400965835354237299e-01
6.344420343558448971e-02
1.362482283916288672e-01
1.425835566959796907e-01
1.390319210870987476e-01
1.101392270881622476e-01
1.389053402801942450e-01
1.404762208290111780e-01
1.405149742432844906e-01
1.383379976132760869e-01
6.644786820082465573e-02
1.389874152424340759e-01
1.435476407914884622e-01
1.397536051641037058e-01
1.113695972082523605e-01
1.416338160568117732e-01
1.417758747568034772e-01
1.419615718216829803e-01
6.549588255748936549e-02
1.394121112991340283e-01
1.429621488795095319e-01
1.368694277337225707e-01
1.090887879707333752e-01
1.403712098829106303e-01
1.414521593437951252e-01
1.418360310170073413e-01
6.451572631910809652e-02
6.650060053469274146e-02
6.675400533547309889e-02
6.696471255505961895e-02
6.846906697028502797e-02
6.571988877938504670e-02
1.231026464503727491e-01
1.350693284899300850e-01
1.102477428419335048e-01
1.237519593760303266e-01
1.330696588157025961e-01
1.342245130236834894e-01
1.426024399101359363e-01
1.122548713772542062e-01
1.414589576855266595e-01
1.439093716163894476e-01
1.453204281279790733e-01
1.110661307905217998e-01
1.353456044707689876e-01
1.417375930688442309e-01
1.073571946331939447e-01
1.109229515478443173e-01
1.105655936227750991e-01
1.401563025752494140e-01
1.403720444134205492e-01
1.426621202112104414e-01
