2.402699820123337660e-01
1.586366288325388174e-01
1.563767258824012851e-01
1.606178455948183426e-01
1.732067377495722094e-01
1.641794812484074773e-01
1.576815220316147015e-01
1.533889372915906990e-01
1.603734583548664105e-01
1.743512061685368597e-01
1.565133718005776720e-01
1.614348888346670008e-01
1.592895484171837073e-01
2.229588400167088480e-01
1.770722466094903913e-01
1.548873292790357847e-01
1.829395891803926588e-01
1.855885726600158270e-01
1.649488916947919326e-01
1.537380102829327133e-01
2.270535313077394202e-01
2.181979111541155480e-01
2.332848975465349473e-01
2.412760661223168901e-01
2.372901259819942543e-01
1.431726349132637077e-01
1.719340706605954339e-01
1.536915628999120931e-01
2.867564174213622086e-01
1.689756173873320222e-01
9.077427989964476085e-02
1.760036409732448903e-01
3.469861971901181952e-01
2.909981629435116068e-01
2.609027759561950432e-01
3.031231540883779219e-01
3.769523068829775392e-01
1.824439156542063400e-01
1.013537305923539189e-01
3.967405078721132627e-02
2.511141095577438739e-02
6.741075846828327965e-03
1.424270811795185498e-01
2.006547320565214843e-02
1.378934474385704878e-01
1.243506819527843005e-01
1.029641218508633993e-01
6.024708615569369929e-02
3.240623516736227949e-01
1.560677088230798537e-01
4.564667855348366471e-02
8.381474647826245294e-02
1.508797675516979908e-01
1.434407703365197795e-01
2.001989539351580472e-01
1.691264401628656544e-01
2.397914214320385762e-01
2.101527365728159680e-01
2.665439922164836162e-01
2.435573918039783403e-01
1.938690836919368943e-01
1.630977778561198410e-01
2.127632772586123822e-01
3.432128017762946515e-01
2.205683720312663354e-01
2.674946057830731028e-01
3.173364697395300027e-01
1.450358007640838442e-01
1.114773040954380873e-01
2.349302917983709382e-01
3.377763210403263439e-01
1.620514610820359414e-01
2.054641372947794697e-01
2.270515873645378435e-01
1.797127497752101788e-01
2.105774638333129598e-02
1.826295149266325690e-01
7.691846397371521205e-02
5.989724246786373718e-02
1.184016436279937134e-01
1.488000829533400737e-01
1.693934345460355317e-01
7.941633741342439545e-02
1.288062831002977082e-01
1.104722412556847916e-01
8.560513480407158649e-02
8.428288500859847099e-02
1.990399955680611233e-01
2.635843120429294251e-01
1.730841491829441803e-01
2.377817953346003932e-01
1.769620079877278485e-01
1.675596521381521598e-01
1.745481405477010417e-01
1.747512951126107272e-01
5.726971502386172391e-02
1.811661885514275483e-01
2.438710823894675306e-01
3.459906159796325986e-01
2.748951617488911703e-01
2.343463137711623290e-01
