1.704547656268308176e-01
6.723212459058101886e-02
1.269350029970155447e-01
1.393452657420957419e-01
1.832706583543658174e-01
1.158189871395864240e-01
2.051847971732578546e-01
2.248124386231730998e-01
1.873202883165764054e-01
1.849164431249456786e-01
1.994945463458342172e-01
1.945599893952021375e-01
2.157345603835502945e-01
1.649239862855600702e-01
1.702980360298949614e-01
1.958695739303948358e-01
