1.237884676347453250e-01
4.211445556861041079e-02
1.464395404251871147e-01
1.627763625427677829e-01
8.870643485448735654e-02
7.506922261783545436e-02
9.527758340309487595e-02
1.259609057309068469e-01
1.008915361097114244e-01
1.450544154366615879e-01
1.050814028076409029e-01
1.109276734950275928e-01
1.732737813160774853e-01
1.629352190737881068e-01
2.425627743214623100e-01
1.725532290769495325e-01
