8.954459563112603104e-02
8.600044492273949126e-02
2.226944560719018237e-02
8.335260825916507299e-02
8.616337612721299000e-02
2.757417188205671041e-02
6.074191371925945215e-02
2.641386870919422425e-02
5.721555221400474733e-02
7.438679023981911720e-02
5.953959481680962812e-02
6.190567261774049257e-02
6.130938237989679712e-02
1.319184035425608470e-01
4.188429669011384249e-02
5.393477209289006258e-02
7.712981949603439635e-02
5.341316144991791609e-02
1.036096544177360912e-01
1.140701878978758882e-01
1.334855427222254864e-01
1.600885205967083058e-01
1.068933073659606575e-01
1.654738728877698795e-01
1.426150359374542542e-01
1.140605940017849207e-01
2.228802628557717269e-01
1.435286110429562778e-01
1.222233303471092214e-01
1.444710027560806576e-01
1.286523662369850607e-01
2.339433041824332260e-01
1.421977799685779364e-01
1.606127132231799370e-01
1.287958334903053781e-01
1.114124159324162006e-01
8.054824747999261847e-02
9.780350873706293580e-02
1.566025865322444588e-01
1.336848937610808918e-01
1.618954444801112558e-01
9.135857980492381736e-02
1.725837089895951304e-01
1.290361032375725581e-01
1.810325050028041005e-01
1.453200821415521204e-01
1.145876684067144019e-01
1.089211027227485473e-01
1.492932730111905248e-01
1.596331514256934814e-01
1.385664471907568085e-01
1.317918730471249744e-01
1.235207837100740780e-01
1.544988888858037646e-01
1.722582360425104209e-01
1.222278675727116320e-01
1.598533607947711654e-01
9.612904940821373478e-02
1.670583618604443710e-01
1.664206625777856496e-01
1.450727625258598219e-01
1.301911300979554653e-01
1.192293010488776062e-01
1.466666023569324906e-01
2.209897854257948102e-01
1.471507900501959620e-01
1.848111794254062024e-01
1.573135060831331311e-01
1.948299035250853906e-01
1.369673332428876511e-01
1.673584427760663185e-01
1.487623423006600443e-01
1.384603316006317864e-01
1.494029687830614184e-01
2.340438145021415395e-01
1.639475807910807381e-01
1.194316894274939228e-01
1.859433385777195524e-01
1.632823908988099704e-01
1.615417532800795253e-01
1.846301591968557976e-01
2.159549406228157276e-01
1.654125779074844815e-01
1.807077778436136095e-01
1.563063486335942442e-01
1.027773440416170220e-01
2.059659677593467242e-01
1.520493518741305450e-01
9.824967174343048060e-02
1.354171673125305342e-01
9.504402001591817639e-02
1.909666458064188665e-01
1.815557221953685574e-01
1.518401913591123364e-01
1.424436265524491319e-01
2.197612492690006192e-01
1.984352987940208313e-01
1.946650297166063193e-01
1.805491934669239962e-01
1.853615697652388206e-01
1.787572388353650121e-01
