1.260308609523165813e-01
1.031866595193815378e-01
2.823557839330812988e-02
7.392547837643038966e-02
1.001069243871965109e-01
9.909932766682826022e-02
8.537972076905694929e-02
1.456292729733552060e-01
1.084970610346107783e-01
8.516451594634698308e-02
1.050365719386788382e-01
7.115171196906325268e-02
1.559434338901505290e-01
1.528150405501946807e-01
6.973362227458543283e-02
1.414693821992187850e-01
1.434172064458694995e-01
1.015383952984008770e-01
1.605048181059268719e-01
1.158925395172375888e-01
1.154270624874698115e-01
8.174685056711986086e-02
9.541886526298745674e-02
1.615405613956681918e-01
1.696729251371625058e-01
1.296429498515163370e-01
1.722890147525154569e-01
1.500715783230799072e-01
1.708681627731913621e-01
1.789545397847317754e-01
2.054737430925552555e-01
1.832728510444912307e-01
1.930966493302828657e-01
1.919092520211751751e-01
2.027480041858955029e-01
2.060275250562251803e-01
1.755023962827041151e-01
1.103152673296370623e-01
1.532109807348416008e-01
1.890559470423165966e-01
1.095936478702172340e-01
1.670335758155068462e-01
1.682338135914715760e-01
1.162114770469578062e-01
1.384793815355246371e-01
1.363167654669198980e-01
1.715430359315807674e-01
1.689396202385138879e-01
1.756402811857137314e-01
1.707820664103984754e-01
1.299304225025340320e-01
1.261193726117758596e-01
2.214753771706735042e-01
2.283063992335183368e-01
2.230301530440696178e-01
2.110097612021490932e-01
2.814123333306409735e-01
1.467908195672162630e-01
2.122881058603525162e-01
1.996284450601356619e-01
1.647701627617397524e-01
2.269668268325823746e-01
1.401951213965031140e-01
1.468011651259775452e-01
1.434272955073258582e-01
1.872700873153427537e-01
1.225362944488341960e-01
2.135715958617696031e-01
2.011372365679842678e-01
2.120070982611056143e-01
1.471692447862901210e-01
1.258438283397341484e-01
1.676027467340016064e-01
1.672598944188883607e-01
2.554180978869016183e-01
1.294806985421858569e-01
1.723475963450395165e-01
1.551067520597895766e-01
2.223452665628148917e-01
1.682129273674665693e-01
1.218845941699468194e-01
1.811663273379403583e-01
3.304068255596436243e-01
2.177531721580845125e-01
1.451584769961650201e-01
1.491502086321885856e-01
1.237965303522427229e-01
2.030724549773507415e-01
1.871888460188459447e-01
2.409677349317532191e-01
2.201895855653744349e-01
2.016144384128543132e-01
2.161039418469254680e-01
1.546812355451878118e-01
1.594865507302949126e-01
1.826671093988876948e-01
1.881739742194230847e-01
1.745553150629768069e-01
2.158464570026038809e-01
1.980389424134045839e-01
2.281744680725611152e-01
