2.677042669933353547e-02
3.718680221048158846e-02
3.787558546359001688e-02
4.063483057829261197e-02
4.221068553026550464e-03
7.663890757920363561e-02
5.095114003569715944e-02
6.251672759418187841e-02
7.398086420368180094e-02
6.664584360120127948e-02
4.306573543838636969e-02
3.178309526349319680e-02
3.106674403016558561e-02
1.224762802072431322e-01
6.883549305124549156e-02
8.106617872246821288e-02
9.013140433972484378e-02
5.256561772554190631e-02
6.829046473404350170e-02
1.113104137509183661e-01
6.939676399504325632e-02
8.249946649336309390e-02
1.034878210486147865e-01
1.033366847231473734e-01
1.432131540887684740e-01
6.958954660568941741e-02
1.159192809804013569e-01
9.383510932941764582e-02
1.724078365559062742e-01
9.780782903738746703e-02
1.578661630159891027e-01
1.145097109144374431e-01
1.368739474452677907e-01
1.284437336994764811e-01
1.995563064822188371e-01
1.496780930857102565e-01
1.466576941960598679e-01
1.042689491464093704e-01
7.260775335005466291e-02
9.280808572965235093e-02
6.752667076384219480e-02
1.019259471638808701e-01
1.174746852977057998e-01
1.722976706441841088e-01
1.522687860853273734e-01
1.353183486876682329e-01
1.260198447219391393e-01
6.526415603002533317e-02
1.488068289286624823e-01
1.607711091921653623e-01
1.191762757029769387e-01
1.385373417397204321e-01
1.529165121397594584e-01
1.514745318787530659e-01
2.071368060491155239e-01
1.341716554642726489e-01
9.364093049864025131e-02
8.264582731778948033e-02
6.670185747424721423e-02
1.158337253214435508e-01
1.568742906266519521e-01
1.384190270960411473e-01
1.145389835851696875e-01
1.093482831672120542e-01
1.716281547202155588e-01
2.127987478273168365e-01
9.164237782085994655e-02
1.217968962832506191e-01
1.800316572094183831e-01
1.705475632513578366e-01
2.081478609022899273e-01
1.262596799810685733e-01
1.875874063967225558e-01
1.592808173305596819e-01
1.195577379954696762e-01
7.240078582253772765e-02
1.131732026434082578e-01
1.254214690182974545e-01
1.092274566645545925e-01
1.292342119760667984e-01
1.276212901413180945e-01
1.026976900924993219e-01
2.038955765203809278e-01
1.488256198085414761e-01
1.310640763728700420e-01
1.184070050994005946e-01
1.807099909682829686e-01
1.669480073560429545e-01
1.636365222492223992e-01
1.834621868225580210e-01
1.270579205637869247e-01
2.074551155181744988e-01
1.314793511292009498e-01
1.225515509529966351e-01
1.072018301862184553e-01
2.431922925618262288e-01
1.191580227375827472e-01
1.422041215924904345e-01
1.343225867346448665e-01
1.614290748794491581e-01
1.645628583680193713e-01
