1.762430582816402191e-01
1.315335442112492703e-01
1.900256235302159868e-01
2.006934551256043531e-01
1.003633979874263976e-01
1.468547644825386189e-01
1.812822074695889518e-01
2.314284325111657381e-01
1.831401464130197332e-01
1.257411451078951359e-01
2.169609503554446317e-01
1.897406134646319464e-01
1.882991334423422813e-01
1.914511928667447516e-01
2.037241923888879203e-01
1.999193678077842429e-01
