1.480052837752737216e-01
4.017425056827050867e-02
1.863285615358368508e-01
1.894032721174880862e-01
1.556755721882966959e-01
3.083064082311466336e-01
3.947564741330487625e-01
2.299767563942753390e-01
1.160317810655604742e-01
4.019350643668855860e-01
3.921953361880566313e-01
2.603601601523613529e-01
1.113679724471044880e-01
1.199528475179769405e-01
1.276075032074004412e-01
1.163312817932039972e-01
