1.817717275892694884e-01
4.490989087415592912e-02
8.952562012044447404e-02
1.229335097928664494e-01
1.751949974069637872e-01
1.601785847118922523e-01
1.525970428982483529e-01
1.715917594597808071e-01
1.832786400004156879e-01
1.645962009539029547e-01
1.721011959847860984e-01
1.822061610208558224e-01
1.718715531086283110e-01
1.777013459442449428e-01
1.770137607319546558e-01
1.629224773496389389e-01
