1.655273437500000000e-01
1.307779947916666574e-01
1.686314174107142738e-01
1.655273437500000000e-01
9.363301595052082871e-02
1.465657552083333426e-01
1.670270647321428492e-01
1.655273437500000000e-01
1.624870300292968750e-01
1.699218750000000000e-01
1.657714843750000000e-01
1.655273437500000000e-01
1.845296223958333426e-01
1.837565104166666574e-01
1.653180803571428492e-01
1.655273437500000000e-01
