2.130160748958587758e-01
6.570635543903335929e-02
1.784669023140200428e-01
2.467450409728501604e-01
1.612864463407147064e-01
1.066354068794420767e-01
1.403067042369262329e-01
1.455066516396722742e-01
1.624445369234308600e-01
1.027446290910510041e-01
2.151306797085063838e-01
2.021582906766395404e-01
1.969741820357739925e-01
1.675303833949978449e-01
1.542554569397387720e-01
1.756108480372599312e-01
