1.372081012542669953e-01
9.943944979542200524e-02
9.769050514192453849e-02
1.443229561970968411e-01
1.294944010608430340e-01
1.807716990421925352e-01
1.350459130730346791e-01
2.199531138924482598e-01
1.141626497514412891e-01
9.346740011824294925e-02
1.909501060436014086e-01
1.683703435451856800e-01
1.806470295414328575e-01
1.904015836272654749e-01
1.818646662203328990e-01
2.139377945734720066e-01
