1.397858490721167468e-01
1.853432463082884188e-02
8.853859203684676105e-02
1.237877618321882867e-01
1.019074932139899109e-01
1.171793287586686827e-01
1.213379477017692137e-01
1.318431639395254984e-01
1.611954414798414670e-01
1.546322783854390814e-01
1.652702706425251133e-01
1.466973110405628555e-01
1.374473720955263212e-01
1.517286219334761932e-01
1.720957746438216418e-01
1.611912583632926776e-01
