1.831597257405519485e-01
2.222222286675657466e-01
1.753110575955361128e-01
2.058531780328069494e-01
2.222222286675657466e-01
1.759259272366762161e-01
1.967592638518129156e-01
1.812789379619061947e-01
1.753110575955361128e-01
1.967592638518129156e-01
1.797839533537626266e-01
2.046957707830837914e-01
2.058531780328069494e-01
1.812789379619061947e-01
2.046957707830837914e-01
1.831597257405519485e-01
