1.782388789124524919e-01
1.554829520069428705e-01
1.771259114570316873e-01
1.945806088482251173e-01
1.324967961928840386e-02
1.693433927866863087e-01
1.643692856172752348e-01
1.514839009328820263e-01
6.188270405462909657e-02
1.664745351299643517e-01
2.004526403173047533e-01
1.642909770180267515e-01
1.069837636192200320e-01
1.620405356185626311e-01
2.205074097280755319e-01
1.527198039776911653e-01
