2.372435267393787628e-01
1.533334908745018765e-01
2.026209350004657128e-01
1.852271938699102116e-01
4.182438600296985859e-02
1.614604595358417050e-01
2.067075589937823199e-01
2.345111983787709076e-01
1.126249387746481451e-01
1.945009779135164485e-01
1.768383674695672148e-01
2.226695245023750380e-01
1.739883252885192633e-01
1.512500253198335864e-01
1.973648912140301415e-01
2.254655483266105875e-01
