1.929373714844517251e-01
1.910870509287073693e-01
1.605483366061329908e-01
1.427788288162376573e-01
1.431565309982173739e-01
7.869643404578360868e-02
1.878787245099934333e-01
1.968496284322240053e-01
1.813918331440967924e-01
1.201502965895297897e-01
1.417793831967104068e-01
1.746363633921226566e-01
1.838560355961537662e-01
2.315452511493976406e-01
5.535719694139865782e-02
1.693374004591113036e-01
1.744048405940142876e-01
1.066450209428484591e-01
2.257405081047461626e-01
2.436162434661617582e-01
2.025715701747685671e-01
9.543217158912178921e-02
1.698444895446300507e-01
2.152449174855764202e-01
1.726088749928749166e-01
9.352366103289219690e-02
1.549664916327366526e-01
2.185380532621191141e-01
2.400355668416103427e-01
1.328579778200946748e-01
2.075703801551403993e-01
2.241879705912791787e-01
1.983711382804008716e-01
1.096126281011563092e-01
1.567244501297514470e-01
2.129109677715370352e-01
2.310710696933361286e-01
8.602522698325068551e-02
5.169898625731898095e-02
7.347273944805447765e-02
1.183632355219183113e-01
1.654381585827440493e-01
5.953826105150465675e-02
6.423193721051435878e-02
1.155445799052428751e-01
1.380120135772113510e-01
1.091226264118002054e-01
1.172701194703292399e-01
2.596224527089641687e-01
1.654637669517587117e-01
1.096498308795092330e-01
2.280168436610927885e-01
2.240449928750212483e-01
2.290239924779878256e-01
2.015430560478797262e-01
1.934620502691429267e-01
2.450910559362875218e-01
2.649040910630272028e-01
1.824457283543709507e-01
1.186048218335669785e-01
2.193833828205242753e-01
2.706943756829087722e-01
2.243151848670095205e-01
1.475248712992582312e-01
2.066018788430553088e-01
2.420650308844275178e-01
1.890189451380417940e-01
1.487278033298655155e-01
1.745892107271804217e-01
2.444031096708316197e-01
2.122467051331813626e-01
1.606691700782483523e-01
1.946598207578063011e-01
1.897778256366459138e-01
2.910493745540196908e-01
1.207921729835036845e-01
1.296960035912119447e-01
1.430372366090663372e-01
1.357427774928510189e-01
9.161373562752626876e-02
1.853939101386528621e-01
2.148553148055305784e-01
1.600475957384333014e-01
1.478497632376205018e-01
1.986118084392868577e-01
2.539693989719336020e-01
2.131520107460136704e-01
2.187897611875087023e-01
2.087349868737734260e-01
2.803787231946793801e-01
1.787529892578906821e-01
2.620129275064055907e-01
1.707512635845117865e-01
2.557093466345507493e-01
1.727538060110349050e-01
1.849319711327552795e-01
1.797075687267911670e-01
2.013876979382565324e-01
1.997995852636030023e-01
2.071896526389397086e-01
2.588483152481225735e-01
