1.474049471577857928e-01
1.699068579518307753e-01
1.305441822630174220e-01
1.084379095969220247e-01
1.073357516747469459e-01
1.845714623966789383e-02
1.587312709861390114e-01
1.325826899522395963e-01
1.174616062223951540e-01
8.420000456792947618e-02
1.325541289720254534e-01
1.246710247225844559e-01
8.649657889215561779e-02
1.520615239591839307e-01
6.762370412432941458e-02
1.564486942952498794e-01
1.648594927257643339e-01
6.640651156284058110e-02
1.605196966375020684e-01
1.424362253612623808e-01
2.031853592668015351e-01
1.917336876145922242e-01
1.243614087263547607e-01
1.838548773501735567e-01
1.053284345152161045e-01
1.122709647461306304e-01
2.275727603297967305e-01
1.843702816941703848e-01
1.765345549914714984e-01
1.219068868018579332e-01
2.033297574828163978e-01
1.703294142535603517e-01
2.240688219093359412e-01
2.566122594937321755e-01
2.609154641585029188e-01
1.923492132348026407e-01
1.659131431773018250e-01
1.125509998922757937e-01
9.385900884528662613e-02
6.120110167354981395e-02
1.465752241153338020e-01
1.342777806160603271e-01
1.009697455674890693e-01
6.343912232506017379e-02
1.259037901111416669e-01
1.442494480059814677e-01
1.513542729344058424e-01
1.458875374790628010e-01
1.970472146106728162e-01
1.770360795434009205e-01
1.378182631508072797e-01
1.919084777630185035e-01
2.220912279833730518e-01
2.497302672037711446e-01
2.483115201959243123e-01
1.728158031518642612e-01
1.640211462699181222e-01
2.298007152320888646e-01
2.183708160255964092e-01
1.594795578253419555e-01
1.754541809742267422e-01
2.072638842778710133e-01
2.478075806911174961e-01
1.829015730092158620e-01
2.136706931901594109e-01
2.175848889521275198e-01
2.367936316698502908e-01
1.477273736705123630e-01
2.048313477739261979e-01
2.123017095459195369e-01
2.373216253203841442e-01
1.762814149260520935e-01
2.309614879150803379e-01
1.678522658319427374e-01
2.216472159354732629e-01
1.627146377774736918e-01
1.503547669809240095e-01
1.412282192479604181e-01
1.669678551932940180e-01
1.267918312246015811e-01
1.226832516698976860e-01
2.175849443659759463e-01
1.272544945292723440e-01
1.700864313665638727e-01
1.596771351488804058e-01
2.187022980427942576e-01
2.634306046932649026e-01
2.379918491037992245e-01
2.252873369994071728e-01
1.710808823713005633e-01
2.312176885288163841e-01
2.815252778908380882e-01
2.026368989967382850e-01
1.063825874488639606e-01
1.903383145914771257e-01
2.812151887382452475e-01
1.890802951145535427e-01
2.023663569528322825e-01
1.901905052363872528e-01
1.424864580711493189e-01
2.149809500059256251e-01
