8.045369018614459411e-02
3.684273968270609934e-02
2.106756524948977596e-02
3.360833772001989295e-02
4.483555330681218698e-02
9.123581728125338200e-03
2.536832572947717371e-02
5.097853175455104024e-02
8.392891159736301857e-03
4.310590435501528150e-02
5.443491924821641098e-02
7.860048852956844079e-02
7.666803098086696910e-02
6.289148751028943163e-02
1.795696064137654660e-02
5.908390213349779679e-02
8.471802916008422391e-02
3.144740982399805984e-02
8.019350178255990613e-02
3.526296882549873751e-02
1.047412448455221357e-01
5.400333899832240880e-02
1.011942479090066627e-01
4.570571239397535485e-02
1.139425142886982267e-01
1.100784130299092972e-01
1.434960815608537221e-01
1.521492049738460972e-01
1.504665416957952639e-01
1.371551499926609297e-01
1.263728987497206024e-01
1.046012869126116129e-01
1.053318510625313870e-01
1.084196020719201264e-01
9.803107329025806393e-02
9.510375764999096093e-02
5.822507936280247459e-02
8.347033793310380811e-02
6.305165837942293405e-02
1.087730307967418597e-01
1.261089979655550253e-01
9.115080377836165537e-02
1.095335696610303666e-01
9.030968974967051865e-02
2.353124669769193419e-02
8.951610561897584140e-02
9.771821456731161204e-02
8.623356717771457625e-02
1.572289909011557740e-01
1.317873059077739328e-01
1.025057076248790805e-01
1.431500877506201030e-01
2.112859253764992895e-01
1.307372304754686743e-01
1.248146230142223312e-01
9.197093146996429547e-02
1.196613789174814646e-01
8.366012710218156956e-02
1.444860017421675802e-01
7.860610694562918110e-02
9.605621489530537238e-02
1.164179794512349292e-01
7.475581364166128395e-02
1.010224561939544602e-01
1.282208419557159251e-01
1.033702176006884715e-01
6.441767036924900269e-02
7.916160146179698764e-02
2.331841226839589595e-02
1.142595835177805663e-01
1.532790359311687889e-01
1.098392287747961132e-01
9.056693553933516105e-02
1.003296844576810204e-01
8.122041089060215435e-02
1.019044760931092225e-01
1.430931583029003140e-01
1.009240789210854028e-01
1.426597646393649721e-01
1.356343097700468681e-01
1.505236071101554163e-01
1.910687569364269423e-01
6.964637571272411232e-02
9.097161263478553694e-02
1.031619969765183858e-01
1.087502784324412969e-01
1.519267705371721011e-01
1.433770583620431471e-01
8.294383020857874766e-02
1.103671637866385086e-01
1.538528076840660896e-01
1.173643830780712605e-01
1.093245351473272481e-01
8.717457357186748912e-02
1.394764685208149113e-01
7.938713897395316410e-02
1.938065225616670550e-01
1.151480451382947412e-01
1.073137156562024991e-01
1.253782636291501940e-01
1.712346517567405746e-01
