7.237816592399982929e-02
9.539741808042051519e-02
2.249683483346678545e-02
7.014537767560333203e-02
8.499506743044968338e-02
4.815324427615381292e-02
3.804452964022157768e-02
8.157613085439571754e-02
1.026744083243941591e-01
8.783003692028265585e-02
3.035129984373970136e-02
8.426540150349655367e-02
8.460999244170334943e-02
1.087016911680201148e-01
4.772643745841028545e-02
9.650616401312216153e-02
1.290142769228343478e-01
6.477037767091622933e-02
8.506963540807752078e-02
8.431262548819737357e-02
9.499164424498583725e-02
1.007014332118650046e-01
6.948318824512310365e-02
7.915083537899100796e-02
1.067041801299917769e-01
1.674483368809048453e-02
1.591702618416792891e-01
1.005732384303253402e-01
1.695422928135555396e-01
7.443036051252140128e-02
1.143208730679291935e-01
1.141272266087560994e-01
9.666344660441748837e-02
1.393778218816106029e-01
1.529075857565658225e-01
1.207991656158880628e-01
1.598606299756703819e-01
8.170648613752116984e-02
6.698933267048581830e-02
4.102116680363766116e-02
5.274724529814333457e-02
5.060502411399641493e-02
2.535912963783350585e-02
4.496825293440801646e-02
2.471833617115547915e-02
9.335352909715766145e-02
4.519823807081243400e-02
5.697636068641888374e-02
1.374413180702294401e-01
7.208222953172829794e-02
9.738820932258161756e-02
9.586827806935196983e-02
1.110716237589468441e-01
1.162158566266253551e-01
1.404022648393248029e-01
1.359889005437323051e-01
1.044713108925721945e-01
1.124120952084082942e-01
1.757504692141083069e-01
1.130677850807772361e-01
1.271611079998994920e-01
1.262935505230696198e-01
1.643103764643176201e-01
1.428685762254575109e-01
1.375269566742645111e-01
1.633675302772854276e-01
9.614082651499372689e-02
1.548276619287207723e-01
1.070424825884401798e-01
1.289563054709175760e-01
1.576873463435241873e-01
1.414589128331639467e-01
1.767019464034372267e-01
1.543094499770981676e-01
1.650059523795229799e-01
1.286096332948475918e-01
1.096525583746440075e-01
9.082800431126368534e-02
7.492123262580627219e-02
7.122708549902129205e-02
9.865184407681226730e-02
1.078120263353831987e-01
1.140948182258468419e-01
8.400969052364906653e-02
9.409821754357275414e-02
1.422063132136267560e-01
1.091426389444117989e-01
1.898289869467799373e-01
1.205819628308885394e-01
1.538783896987577227e-01
1.317406729442434643e-01
1.243337544146925211e-01
1.161490971341593709e-01
8.678267407678784406e-02
1.621352057330883445e-01
1.461971379064310184e-01
9.904597883220188359e-02
9.217191881571824841e-02
1.777034566486970779e-01
1.321255125042695711e-01
1.678621703758835793e-01
