9.847832224886587937e-02
1.739614121984881800e-01
1.433636470298519650e-01
1.712148491615153034e-01
9.143810320944924241e-02
2.653230059525404916e-01
1.432720543178273298e-01
1.965103681829662441e-01
1.413156698274958267e-01
1.358496526408998761e-01
1.749027328623924404e-01
1.645733221994305495e-01
1.089713064783219554e-01
2.615416437557931822e-02
8.315508275076613498e-02
1.402138938927756928e-01
