1.510417271369638437e-01
1.364593850370371120e-01
1.681901553607671185e-01
1.315763903213127695e-01
1.098689652639082970e-01
4.449411889184445162e-02
1.028612323570996523e-01
1.098162255769308954e-01
7.278951785589854451e-02
1.180321735401566180e-01
1.363145791625496595e-01
1.017578738437105862e-01
2.066139042950593530e-01
2.201005316411073498e-01
5.289854933373415447e-02
1.708382906105656018e-01
1.365812111717577271e-01
1.356268655866957606e-01
1.936509658475048246e-01
1.011554751827274112e-01
1.708983019097314038e-01
1.075204725448901805e-01
1.990886472541695540e-01
1.679029741969246259e-01
2.245932412691987456e-01
8.899934273862387946e-02
1.392736940716321759e-01
1.428440220725651078e-01
1.516900296824482686e-01
1.369308561552315950e-01
8.099917480565356487e-02
1.813634174446073777e-01
1.092308247103714047e-01
1.489981628524569279e-01
1.479318740177684721e-01
1.531963605039681486e-01
1.030068756484140008e-01
6.810700040030216729e-02
5.901597058758712572e-02
8.412473342524698361e-02
1.222346623141605110e-01
6.362221571879882187e-02
1.353167536435648799e-01
5.982943343070264153e-02
1.302786732737261643e-01
7.665911005236782094e-02
6.188293483753044139e-02
1.318447810884278426e-01
1.298973349890170104e-01
9.645392438575911553e-02
1.125400435381869457e-01
1.544253114597477772e-01
1.624979473417624831e-01
1.631673936947033998e-01
1.228233132815848144e-01
2.020169004323319195e-01
1.483757094784568242e-01
1.989420660269948238e-01
2.107810204884467131e-01
1.569413152711394421e-01
1.714372463667621915e-01
1.382241946680901057e-01
1.657894143382481478e-01
1.301371539280248291e-01
1.458712530394013218e-01
2.188611262468979357e-01
1.712365749005514970e-01
1.052568123693792823e-01
1.700218529082261620e-01
2.592655016969029891e-01
1.971343494050625533e-01
1.461967482822588982e-01
1.317072598120340998e-01
1.677307827541461294e-01
1.794569778900880208e-01
1.601045214830754404e-01
1.417020336817726156e-01
1.383829065304710837e-01
1.643707634424432518e-01
1.655689166375221011e-01
1.116171575849875808e-01
2.361615520472136742e-01
2.043789342905466266e-01
1.018247863515241020e-01
2.405310272812270223e-01
1.169360505345349160e-01
2.280758478893683550e-01
1.139897554922544437e-01
1.634840147139934308e-01
2.102873324452397830e-01
2.407741346900225954e-01
1.341041031062979172e-01
2.113660124058906742e-01
1.386209398758812550e-01
2.322509030883128933e-01
1.830580662667321556e-01
1.464980512570876470e-01
1.703539726396019749e-01
2.616926435237893478e-01
2.175188528087276807e-01
1.710594007566284547e-01
