1.073695688347260507e-01
1.001942902087019083e-01
1.211606697246539743e-01
8.606916256562377465e-02
1.205541818545987909e-01
6.291002059767308863e-02
9.623530982375647080e-02
6.143465367830895640e-02
1.017655539684570731e-01
1.509448288975713259e-01
1.092041411813205187e-01
1.933774344856479255e-01
1.529532504053069952e-01
1.894756592810153961e-01
3.078793306261874002e-02
1.192884995857289437e-01
1.448348697651034300e-01
1.238448814054628755e-01
1.600006116658243271e-01
1.141911814293752464e-01
2.066047262901870019e-01
1.206497904719211756e-01
1.514738352539447552e-01
1.642337199031876915e-01
1.691233422864640290e-01
7.771095063519449508e-02
1.692138064737754022e-01
2.398486356161391442e-01
1.605480229291760541e-01
1.920593957810734220e-01
1.060507012080051936e-01
1.767123733969548638e-01
1.853145903755480939e-01
1.471782659646123648e-01
1.855990613739077755e-01
1.644556574840232988e-01
1.702990318970898087e-01
1.310086373884517541e-01
1.061418300898647193e-01
4.380936324685955063e-02
1.125831100552414504e-01
7.616231919382698834e-02
8.488241042225407040e-02
8.951699303445191658e-02
1.028639406915597410e-01
5.649345794406075011e-02
1.467923887629205282e-01
1.085867640168334397e-01
1.234095392529315355e-01
1.544816550583793524e-01
9.432234274313835987e-02
1.719367480411445048e-01
1.415176189195615497e-01
1.393886282502745100e-01
1.283156087335485807e-01
1.061681958179598595e-01
1.704256213180577462e-01
2.397736351972875601e-01
1.250451297606699763e-01
1.203388860090993939e-01
1.276455415589645426e-01
2.384305265553008923e-01
1.804198792490821490e-01
1.683612576900766489e-01
1.740109401826675228e-01
1.527805621690976612e-01
1.327398894981552668e-01
1.735139404532114460e-01
1.477170809924315820e-01
1.603958223265810612e-01
2.074190946027206772e-01
1.925645746433964078e-01
1.344680077342603197e-01
2.082374837661448708e-01
1.389861349872752172e-01
2.289802526714853348e-01
1.506618831235055633e-01
1.627718679508409205e-01
1.464811078845881520e-01
1.336325587292846451e-01
1.620997146774943165e-01
1.975034514012244946e-01
1.643650616304232481e-01
1.432408417801455669e-01
2.374919699639296833e-01
1.230554741706817723e-01
1.199827115767850283e-01
1.951633547880471942e-01
1.393357523215504878e-01
1.707619466206569403e-01
1.325815340320472269e-01
1.560527423325066276e-01
1.966320347184171979e-01
1.827912080916576087e-01
1.855310580867808312e-01
1.229860932530405376e-01
2.000310342096222049e-01
1.090138481500057127e-01
1.858698716700578624e-01
2.432152511408695872e-01
2.068932886244370939e-01
