8.856482668600690333e-02
8.944254438280879738e-02
7.768891087947010776e-02
6.246174668619740300e-02
1.026786548309946007e-01
7.639597030468464611e-02
5.880701909616338485e-02
1.089109508045042335e-01
6.503383545742298655e-02
4.543825473172966034e-02
1.738240858853364740e-02
9.443399807451687000e-02
9.747291775420308113e-02
1.105816947260441635e-01
3.754962013604549315e-02
9.506929203457467614e-02
7.041981097063398920e-02
6.680981025732972423e-02
1.285633816763807891e-01
9.082491678194716533e-02
1.345984036101981474e-01
1.019217987979153250e-01
1.324578344193958757e-01
1.199615156029512214e-01
5.279901967598842061e-02
6.444948021537409699e-02
1.125270802776168061e-01
1.401313277450614014e-01
1.396025144573426469e-01
9.412607442051851292e-02
7.774170668632834902e-02
1.525137345356947227e-01
1.184056065125892315e-01
8.852512464279872761e-02
1.406106274718275373e-01
1.126672087098436054e-01
1.842520132374305120e-01
4.663912599065266062e-02
4.624540156657111489e-02
5.689497864267860361e-02
5.830286469566859503e-02
4.242064238033330797e-02
7.700485684799437958e-02
5.078162300357619979e-02
8.202752592310738611e-02
6.857887771911919117e-02
6.090300613141153008e-02
8.673477447588923139e-02
1.110134585037835381e-01
1.337285501649603248e-01
3.213045731977742098e-02
1.211619760023705389e-01
9.600649195908772526e-02
7.535068876243783409e-02
1.056389743081616317e-01
9.239873075477170183e-02
1.644471157972632880e-01
1.309346449785292743e-01
2.027987488500702373e-01
1.058883792130263096e-01
1.112833887293443458e-01
1.036094499249884393e-01
1.471098818714940970e-01
7.378616637680142365e-02
1.361071305017013955e-01
1.714469476685805405e-01
1.307000076810184708e-01
9.050262464174571586e-02
1.243891975430485158e-01
1.240896046801935881e-01
1.914400176998382330e-01
1.571633075408709057e-01
1.170504374805694525e-01
9.148307767016096437e-02
1.339753183822792182e-01
1.091844377280477424e-01
7.421507897491280703e-02
8.180365241677761690e-02
7.745245697151403874e-02
8.584506372583816658e-02
1.352427661589060137e-01
8.180689253159610652e-02
1.071773262989993841e-01
9.033945076225791126e-02
1.875513864875896497e-01
1.160372734185120130e-01
1.348046144524302492e-01
1.024422695140506517e-01
1.043046659346705679e-01
1.652490436338725777e-01
8.132624345216754591e-02
9.588613514314112130e-02
1.522377814925186257e-01
1.229342190087593795e-01
1.065584568467994181e-01
7.685050870993738459e-02
1.408865348128948980e-01
1.230186934744079558e-01
1.772187038385219793e-01
1.725214518552932730e-01
1.635325964307412505e-01
