1.593734482247642636e-01
1.591432794146422050e-05
7.062693272903745878e-02
1.511026123911263785e-01
1.608901750808036379e-01
1.496157119136503899e-01
1.561670307252473466e-01
1.715999483541338910e-01
1.561580271848626855e-01
1.522142283180876743e-01
1.494137840696265207e-01
1.623318318330377596e-01
1.598847130826097640e-01
1.599029120041987884e-01
1.611604481555349022e-01
1.558299875859725792e-01
