5.197703240152735243e-02
1.096216290114590819e-01
7.033742373040205442e-02
1.087619108987452760e-01
1.086358433195318135e-01
3.094619451310511374e-02
9.189159758478546158e-02
9.697485924474537333e-02
1.008113785646855831e-01
6.841531062337129210e-02
5.408789971318921086e-02
8.988466962070490451e-02
6.088738141317243113e-02
1.021361251881059556e-01
8.241172047851054450e-02
1.356696189531283736e-01
1.133697618088000680e-01
1.042609564207780809e-01
1.146031306992763565e-01
8.534368325357578888e-02
1.207075625246104150e-01
1.000346308106455917e-01
8.671402869501540489e-02
1.755991167701744515e-01
1.143635018597706221e-01
9.357439283780877304e-02
1.561444244938544335e-01
1.192134022154384965e-01
1.130962073408367241e-01
1.793344763083859206e-01
1.898870436886612167e-01
1.530508937072367071e-01
1.321035602915591467e-01
1.612880621978547424e-01
9.050507257285070328e-02
1.380089706865807453e-01
1.939237808199742730e-01
1.286231329871903029e-01
1.908210580799837297e-01
1.720351234458716017e-01
1.975898787271804513e-01
1.722476289296786534e-01
1.569184798949631310e-01
1.571709235679963901e-01
1.780130339884740953e-01
1.786840944438993772e-01
2.109494513337827337e-01
1.850893697259240189e-01
3.099224666008152385e-01
2.174117655841445729e-01
2.197631206748187627e-01
2.309602463188079602e-01
2.111072795501408583e-01
2.615734318208594034e-01
2.352393394387949921e-01
1.994241275936544100e-01
1.647997183429721901e-01
1.838981720589240032e-01
1.806635544456254849e-01
1.908617586327286952e-01
2.079793063995356850e-01
2.407133836225683332e-01
2.573173405636715594e-01
1.525417074184812483e-01
1.668145200160674468e-01
2.108853991443398745e-01
1.653574003425607453e-01
1.823084599410112194e-01
2.166657281430581505e-01
2.929011600880095378e-01
2.325872495197332801e-01
2.173040989690399882e-01
1.580235817220035088e-01
1.998848042071585951e-01
2.183172888337419626e-01
1.748522699945169734e-01
2.133450838199888178e-01
1.851551233647534545e-01
1.927923861120899029e-01
1.821209020496238618e-01
1.991472195726461114e-01
1.839195082457487362e-01
2.707701540081101088e-01
1.959974430210422724e-01
2.466008559525877109e-01
2.234544923099187619e-01
1.854713943813784127e-01
2.162369745425306855e-01
2.290033050723230545e-01
2.016897601683102503e-01
2.622333515281262684e-01
2.081846370201674290e-01
2.303792056806672206e-01
2.428692349541836104e-01
2.043839448841796302e-01
1.695663770750308330e-01
1.646879597807618112e-01
2.220909836654064162e-01
1.672965244651655192e-01
2.155681484234354961e-01
2.383957559672685855e-01
