1.567463022967179598e-01
1.453586002545697309e-01
1.459128438229007341e-01
1.990170835384300896e-01
1.055215429514646530e-01
2.045714895107916542e-01
1.915429829220686719e-01
1.858871798031032085e-01
1.362002732764397428e-01
2.354891920196158506e-01
1.358320856732981585e-01
1.849417521485260674e-01
1.600864294783345410e-01
1.835274653775351428e-01
1.898040792106517605e-01
1.682632403847362235e-01
