2.085441656862922939e-03
3.136731717217763893e-02
3.035211702454914881e-02
5.382792278559337881e-03
3.554667359382680802e-02
1.831580844571279593e-02
5.526791798265898560e-04
1.880834869071179583e-02
1.669071178666679464e-02
2.222579639583098315e-04
2.821427804733590144e-02
6.575320471435147380e-04
3.069692892867227976e-02
7.677918412698020445e-02
8.622236501049393431e-02
5.686695857479557442e-02
1.332876327505314318e-01
8.934247763737893089e-02
9.174854901468602886e-02
1.060022302335622835e-01
1.025649672023667691e-01
5.977844579942589304e-02
1.420687590300356296e-01
8.661763076197678823e-02
1.649757772684097290e-01
1.656011999405633817e-01
1.718725140554145103e-01
9.740732897640433374e-02
1.942525804177141491e-01
1.255576109567930199e-01
1.340137867782736081e-01
1.318828412884333612e-01
2.130099574718148925e-01
1.534172462415881455e-01
1.560915913474463512e-01
1.604376697751621894e-01
2.011812203205548821e-01
1.487208361907575438e-01
1.063658837667669776e-01
1.634724411414936185e-01
1.678049083129735664e-01
1.952172543035256003e-01
1.408419542310114791e-01
1.510567764822125236e-01
1.754467698449913571e-01
1.664836755786522071e-01
1.550998409254064625e-01
1.960400704724284404e-01
1.387544161515979202e-01
1.348878209447810506e-01
1.516053794095149343e-01
1.337996107448501670e-01
1.527257038298280023e-01
1.134805898577608135e-01
1.652556910571547633e-01
1.621049308564972979e-01
1.433067880559000529e-01
1.592930786938520360e-01
1.516569280373687434e-01
1.643039622940705158e-01
1.447322678890456127e-01
1.800475796538963669e-01
1.875811294229073056e-01
1.493930746129570608e-01
1.570550881090911621e-01
1.498594233490761207e-01
1.294974361976178878e-01
2.111874341678161016e-01
1.552473565170810754e-01
1.077096065065821506e-01
1.450905327029921310e-01
1.871076848694708805e-01
1.796010879492611623e-01
1.555941389462112412e-01
1.883891785047091261e-01
1.714206798933446407e-01
1.631819998555538997e-01
1.916273736482550505e-01
2.215187849897819750e-01
1.959564676284431817e-01
1.894903301368825732e-01
1.818586663641338641e-01
1.659786237958612021e-01
1.768627154711933935e-01
1.537990881499284312e-01
1.676428867005456680e-01
1.341773916458350868e-01
1.893400030914750287e-01
2.445612366450055086e-01
1.493452657021433760e-01
1.504669182512237413e-01
1.037391593455127409e-01
1.465576091358903321e-01
1.683797432397463600e-01
1.652408896652674541e-01
1.431411383275469906e-01
1.809360130327359595e-01
2.110083243169356138e-01
1.611113315775583033e-01
1.554502239585137668e-01
1.777586463525109850e-01
