1.086410517231203021e-01
7.773703136123143176e-02
1.229747982265857603e-01
8.445787553388911517e-02
9.413394493122513584e-02
5.262211672603511053e-02
6.708084872493949580e-02
6.432524294807361043e-02
7.315073248285514085e-02
1.782409992928688236e-01
1.175856287232958375e-01
1.274618322674471727e-01
1.225657773275787982e-01
1.491418344040329746e-01
5.964863770462285747e-02
1.276350908267956386e-01
1.412214149291125542e-01
1.021232416253322062e-01
1.159365053933400364e-01
1.367614249913738367e-01
1.438723192192040978e-01
1.812921551844248469e-01
1.376341432332992554e-01
1.581167382403061983e-01
1.178324653838689479e-01
9.458061484978176614e-02
1.018956572605440314e-01
1.462941701667239969e-01
1.809017357703011641e-01
1.571927690305388869e-01
1.596885070992777045e-01
1.423009463514272877e-01
1.230904543414138852e-01
1.375626249310488991e-01
1.867764634438432159e-01
1.782270899364868100e-01
1.578431383420068612e-01
6.959298489024288992e-02
7.975080132914277864e-02
9.303186168500150732e-02
1.007513144555000212e-01
9.930719739797776169e-02
1.120288655376778242e-01
1.152773600859710867e-01
1.206998997547018976e-01
1.069827431906910237e-01
1.026519490047716199e-01
9.597604284779383266e-02
1.724657732993364334e-01
1.258600335568189621e-01
9.626291085665937552e-02
1.316556707740976218e-01
1.187362170849855098e-01
1.299183136926820581e-01
1.404676759579720491e-01
1.212166325332453554e-01
1.278426179375786176e-01
1.275736305217903266e-01
1.186800599814607504e-01
1.360674262440834947e-01
1.440773950531505643e-01
1.150177496198851318e-01
1.473189999994177213e-01
1.443374634075623164e-01
1.415851759151197375e-01
1.324627239686938518e-01
1.681104650219472640e-01
1.279271717693728216e-01
1.208245200821413401e-01
2.023372962497747840e-01
1.708399569257520734e-01
1.357252846758525977e-01
1.279256997200158841e-01
1.688613276212261316e-01
1.710014579674372370e-01
1.269553643349074501e-01
1.107778799039526585e-01
1.317511019923795768e-01
1.270345174707472324e-01
1.273691888826970764e-01
1.638813640501421698e-01
2.231793726006379430e-01
1.090681826910720464e-01
1.476214061616561712e-01
1.484690768500933344e-01
1.706836827170963578e-01
1.559688100376381281e-01
1.465538430672425618e-01
1.574400141118810770e-01
1.741360088165562758e-01
1.876414998506124310e-01
1.359862282943840317e-01
1.986072092818526036e-01
1.347544257206698959e-01
1.484549001862223438e-01
2.085853011275713154e-01
2.060969714791728857e-01
1.976156860160139805e-01
1.766257797940992413e-01
1.369170139615352444e-01
1.637902844052475104e-01
