1.389303736818524593e-01
8.793403876300615041e-02
4.413933099175874897e-02
7.169884984166575992e-02
2.850186504745998994e-01
1.055140108443223534e-01
1.100451622803050727e-01
2.078173193149268627e-01
1.952123199231349526e-01
1.125156897155997898e-01
9.971738127597536139e-02
8.003471850847396207e-02
2.964500683682182447e-01
2.350785388396336439e-01
7.765198491800290315e-02
4.479717669220498188e-02
1.663526027606656854e-01
1.223081896762148735e-01
1.225538028833957765e-01
2.036287930364218957e-01
1.733177325759942822e-01
1.534571298935379080e-01
1.839057528951133780e-01
2.014714259331902568e-01
2.634140865769810658e-01
8.130852638099056451e-02
2.307704831831730308e-01
3.767741642749080078e-01
1.758473204592099493e-01
1.137490344878572673e-01
2.703644902660296556e-01
3.323167044347009047e-01
4.080460659729746586e-01
2.340264186943666336e-01
2.141754657495766878e-01
2.784241249856467260e-01
4.281477826790741070e-01
1.592896933703181750e-01
9.384679645658113023e-02
6.002136701359771925e-02
1.253803450381383300e-01
1.932429852089486422e-01
1.458368162588717931e-01
1.259494421179764567e-01
1.253229908179491758e-01
1.234074212664451747e-01
1.097852040368777066e-01
6.916541179928642480e-02
1.056386570159632415e-01
6.651852885261178017e-02
2.275729537941515446e-01
1.827538316854490641e-01
1.344685177676952781e-01
1.465231006105358891e-01
1.137136263737025116e-01
1.144735026173293591e-01
1.125802541366563436e-01
8.815310354559467709e-02
1.552246508833307614e-01
1.266650201466221204e-01
1.188332940308520491e-01
1.168722134226789777e-01
9.726633045535820754e-02
1.420137070907423193e-01
1.408639476867392659e-01
2.046005755949478755e-01
8.431376871437980258e-02
8.776844197955842308e-02
1.062717971821817015e-01
1.090790535896443425e-01
8.376575290010525310e-02
1.428188349012858571e-01
1.982123638646533792e-01
2.837616917319022436e-01
1.435089240638682540e-01
1.954689547777749004e-01
2.189686544812642632e-01
2.122999894826744505e-01
1.878359951078891754e-01
1.532811490424837164e-01
1.124689634531163274e-01
2.163385734176979658e-01
1.833919771732046011e-01
1.905417404710673390e-01
1.638643194992955021e-01
1.728167619126347310e-01
1.496825444583709530e-01
1.044621033450731928e-01
1.330309908908720307e-01
2.019551786540362825e-01
1.676530615211679343e-01
1.466799105445925899e-01
1.111960610589728948e-01
1.857511343506093315e-01
1.169593695980998133e-01
1.570297253962892881e-01
1.523147319945005185e-01
1.190372747010909615e-01
1.767533345577808612e-01
2.264925511195682584e-01
1.413138315009956070e-01
