1.658866455276998275e-01
1.075037390647384378e-01
5.529820199052874752e-02
8.837529773322436166e-02
3.084725309879733923e-01
1.290078893697892137e-01
1.345474942802236673e-01
2.249108867433208814e-01
2.148279438798244290e-01
1.378748430512272416e-01
1.238544440264097157e-01
9.879451739386869991e-02
3.239321269882985965e-01
2.583491121633694765e-01
9.493405687121245218e-02
5.185800540046049678e-02
1.798205257106859078e-01
1.486275873075310894e-01
1.452575316652655602e-01
2.225443108293872485e-01
1.919837811818489726e-01
1.776885752781079408e-01
2.056616939281901424e-01
2.295496931586127887e-01
2.891417441244881759e-01
1.000041056316919030e-01
2.568881982364333849e-01
3.879527734019435625e-01
1.910554386961918483e-01
1.337895776467541153e-01
2.953031603246927261e-01
3.520284598120130282e-01
4.281457009940193292e-01
2.589283996404936894e-01
2.362697683632946910e-01
2.934318386519757516e-01
4.408957880133619889e-01
1.890508039639546278e-01
1.154613056793235837e-01
7.223782554053916061e-02
1.522413576379991473e-01
2.242332253999148317e-01
1.734093905856403106e-01
1.522433128064641650e-01
1.517315841853045522e-01
1.503215716578639449e-01
1.344568026610291900e-01
8.625748477732905761e-02
1.273281170198550527e-01
7.792899521211019143e-02
2.576038111001253128e-01
2.098213475770675240e-01
1.580741257191850546e-01
1.707210280001163483e-01
1.355680570078010849e-01
1.354289755869943490e-01
1.330937668681144714e-01
1.044952151580498811e-01
1.628759628376708624e-01
1.550812417498001750e-01
1.443263486457558864e-01
1.412410172992027702e-01
1.176560512528969649e-01
1.669128498134131722e-01
1.681958869135437018e-01
2.285073348679221572e-01
1.041555058640929315e-01
1.048271750780538913e-01
1.260910405275913471e-01
1.244216561317443848e-01
1.017487122892187235e-01
1.595054018812683827e-01
2.183159299982855017e-01
3.067872353041401490e-01
1.625561994285537604e-01
2.278498431058743889e-01
2.537407373758749363e-01
2.486294495443311936e-01
2.226507889035229393e-01
1.813510128368552021e-01
1.356797372349179687e-01
2.527100880128833049e-01
2.149786179741987879e-01
2.266300489158871168e-01
1.936706053809477690e-01
2.035888165880281320e-01
1.760087301238225099e-01
1.242956052032800768e-01
1.559903680418546490e-01
2.290135866944463250e-01
1.910516661950028838e-01
1.687585934280202982e-01
1.322909681341395971e-01
2.101859996238580053e-01
1.405706221524339328e-01
1.861899104685737494e-01
1.811954850116028193e-01
1.461213323502586481e-01
2.075734187920506291e-01
2.599298774909514775e-01
1.698339822200628513e-01
