7.149802936384311303e-02
7.086071954108774662e-02
4.720479139583543676e-02
6.502779471114851495e-02
4.376854491420090199e-02
4.216570186858566854e-02
6.398618294714161769e-02
8.026771282759280479e-02
7.826640392438723171e-02
8.457722340692551410e-02
5.880157279674536747e-02
6.123083199446018032e-02
8.638310754814973458e-02
9.362393716135276878e-02
2.306499758000987027e-02
1.156849115773534026e-01
1.220104952159230260e-01
9.205376229678782773e-02
7.762212459839737400e-02
6.788627735267464824e-02
1.458079230371647772e-01
1.065675493401403578e-01
8.925931206277500085e-02
7.231436094913917811e-02
9.762695453201349072e-02
6.256372908739230021e-02
1.335820431749407955e-01
1.299376301736069328e-01
1.516322136426774270e-01
1.066622783591111151e-01
1.351649778393598789e-01
1.473812802623097606e-01
1.145726694689633701e-01
1.224337121328482325e-01
7.536629145369470872e-02
1.176141235046088696e-01
9.127369198876504608e-02
6.815858542149026700e-02
8.979667179944673949e-02
8.138888219120697654e-02
6.112106454048234216e-02
6.529927518512032569e-02
7.783222116995602846e-02
7.282770125395753025e-02
9.493008235362000724e-02
1.036197762228906749e-01
7.825960684567689896e-02
1.394118128451876937e-01
1.170741833316592123e-01
5.343960732436524308e-02
8.387247778367824813e-02
1.462871711298178723e-01
1.274589107085306039e-01
8.609808429789084228e-02
1.115687023669194727e-01
1.272621510120538479e-01
1.545375317084388134e-01
1.368034233589871529e-01
1.438049155896386211e-01
1.294310878998098380e-01
1.143378849105479572e-01
1.204221775361265095e-01
1.515581171596959986e-01
1.333692477783188224e-01
9.820092895265239430e-02
1.933734983277435593e-01
1.117312804204770027e-01
1.160534793251337404e-01
1.125122522577070294e-01
1.122563122682130043e-01
1.385963547150962649e-01
1.162382619670377371e-01
1.351572401673855339e-01
1.302582454966166314e-01
9.103561976315596715e-02
1.335195847473537034e-01
1.106709976716396954e-01
7.782202425341193386e-02
1.098815798580359965e-01
8.063096965913875425e-02
9.534678591164545691e-02
1.452447695371050229e-01
8.353751889752367155e-02
1.253493631240696904e-01
1.543938529391128411e-01
1.723946741638848479e-01
1.751825718495708117e-01
1.606356918592400096e-01
8.933094292073152920e-02
1.260895178733895117e-01
1.402766148687358272e-01
1.520302826538681984e-01
1.399902445129835304e-01
1.433179654189958574e-01
1.567113095751175578e-01
8.332167031879250674e-02
1.476932502387521273e-01
1.364112093041722484e-01
1.231392249800802169e-01
1.523885633975554099e-01
1.084560336401829417e-01
