2.501141075394116564e-01
1.072221887247256505e-01
8.835932145822360251e-02
1.879725612431814574e-01
1.017632939100232281e-01
8.022626928452934736e-02
1.275454205460846424e-01
1.939686101354059777e-01
1.730728155006155677e-01
2.181229987930107250e-01
1.995237345108762383e-01
2.120276977322126666e-01
1.386386111012793132e-01
1.657167781187516564e-01
2.429114795689071848e-01
1.295684965163153290e-01
