1.980413691257126574e-01
1.066569089473757420e-01
1.713998368941247463e-01
1.445121083358701930e-01
1.073816636157321897e-01
2.031763481707977437e-01
1.781554139036286011e-01
1.471302291226623260e-01
1.586323032014271550e-01
2.142480266879179529e-01
2.106531047258093647e-01
2.010982054819448472e-01
2.198822116811892935e-01
1.609203285437875441e-01
2.199107552213328265e-01
1.952924665986626729e-01
