6.543526862127085897e-02
8.069923030094676430e-02
1.136191820504401651e-01
1.860342970633480086e-01
1.240334002883563269e-01
1.314084245954185437e-01
1.413456117744707197e-01
2.185979655695129142e-01
1.731010606641315841e-01
9.798671425338463525e-02
1.059309634910375469e-01
1.342919946152148492e-01
1.026667657528638061e-01
1.648232456271736257e-01
1.143921583069251457e-01
2.168447910351137542e-01
