1.812791029534613074e-01
1.589299271415386960e-01
1.780708849297038265e-01
1.749158057251146980e-01
6.264754752503774726e-02
1.592376937395394154e-01
1.579760754456011884e-01
2.311726077272656388e-01
1.754228455637140971e-01
1.664144879572891644e-01
1.937056549691728302e-01
1.836354902812412926e-01
1.828685218933969736e-01
1.776893401984125376e-01
2.288616978579998962e-01
1.583138250280171633e-01
