1.756387378668781141e-01
1.914065217466226765e-01
1.421361837003912165e-01
1.446087041736713596e-01
6.366675746228013522e-02
1.848624303238466382e-01
1.545883079857698628e-01
1.391493034700813092e-01
7.758724722433336940e-02
1.754009620945323200e-01
1.891520390428403087e-01
1.425392421447863323e-01
1.979137761185743860e-01
1.358399620678807929e-01
1.881109362935343976e-01
1.411279353279886462e-01
