1.243938620763799519e-01
3.759939631546062311e-02
5.499950586384549228e-02
8.830596078708784213e-02
2.290304507144875351e-02
1.356626593749279686e-01
1.134737838077194833e-01
1.034698702592902475e-01
1.102700637735551936e-01
1.332359010708452363e-01
2.655220300359165675e-01
1.592034128026235951e-01
1.158243535510661976e-01
1.445144570631042846e-01
1.487246312218368505e-01
2.355632616011007485e-01
