1.473161499881560643e-01
5.028381441574303334e-02
6.651897642860409021e-02
1.052828464367053379e-01
4.476141060110551406e-02
1.567905853997608456e-01
1.390340978517435044e-01
1.231329418490802741e-01
1.420434665606405411e-01
1.550610239758043463e-01
2.933007174060549005e-01
1.854170410936473723e-01
1.348319386921811580e-01
1.615186113716634286e-01
1.761962948862105804e-01
2.728958481935218616e-01
