1.139136303860980720e-01
1.264122729682220225e-01
1.284655115405957393e-01
9.996824363770429045e-02
1.125121053594809323e-01
6.363466103077651537e-02
1.023101354053673889e-01
8.265848099612273236e-02
8.468646551661479505e-02
9.209483957853920044e-02
8.219364897544997883e-02
1.020410789597707840e-01
1.010993752458419354e-01
1.457699594410279686e-01
8.083434393539881690e-02
1.004737778152607758e-01
1.400016899726604369e-01
1.255194920365913513e-01
1.266912868103155787e-01
1.182365878350817856e-01
1.539854877975393166e-01
8.510086212593775956e-02
1.650291118936505763e-01
1.534439298369621729e-01
1.397068903047161692e-01
8.811854739458514774e-02
1.585976574749041190e-01
1.862203476216214293e-01
1.911285466586168102e-01
1.160526862009786664e-01
1.689453824745634491e-01
1.191353030466976021e-01
1.609569941110049196e-01
1.600245751727085719e-01
1.445206252571482053e-01
2.052983029279857874e-01
1.305204340471671220e-01
2.074421777260095634e-01
9.574893442126827803e-02
1.075294436528705655e-01
1.641978278326300389e-01
1.476393648100873535e-01
1.121029271565091162e-01
1.764315153257204893e-01
1.873978173646789203e-01
1.313385002744885677e-01
1.930424741720064286e-01
1.340221160879501994e-01
1.594050474679813978e-01
2.114182097407487637e-01
1.853911597998096350e-01
2.339918908591453739e-01
1.816652955917211765e-01
1.573217831766949293e-01
2.595394296714892968e-01
2.061540196076608600e-01
1.853308875758487573e-01
1.511723839749510578e-01
1.628790740640117529e-01
1.730740396305918694e-01
1.682432760985997922e-01
2.126562719304974369e-01
1.824302347376942635e-01
2.178610589068669667e-01
1.825111549920760690e-01
2.070472110062837601e-01
1.986185421164219089e-01
1.072295980098155882e-01
1.303896124546344570e-01
1.807841880766388187e-01
2.166213545088584713e-01
1.977981101864805524e-01
1.747560599245704116e-01
2.497124575490418663e-01
1.753179261890741580e-01
1.316064640413969755e-01
1.378030457462255665e-01
1.679844584387655548e-01
2.279871621240790180e-01
1.852289608034949908e-01
2.273108923377898938e-01
1.864612783090426329e-01
1.753028009373407969e-01
2.073792031464668506e-01
1.478352779164337216e-01
2.159968874632166025e-01
1.714700421390052132e-01
1.956094189618642620e-01
1.721534486860036850e-01
1.574659014183383277e-01
1.932566291294418870e-01
1.828946022746654743e-01
1.722493574668008676e-01
1.865929812192916870e-01
1.848088803772743038e-01
2.123353667915440501e-01
2.123407793159668155e-01
2.121826399905750449e-01
1.865922616651425059e-01
2.404974214374445973e-01
2.235142053821339014e-01
