1.292665835351120562e-01
2.417435463341937457e-02
8.766047941181957792e-02
1.383728048763706309e-01
1.622456412674304349e-01
1.602462868210880464e-01
1.842172666386301949e-01
9.860821924085187706e-02
1.654340428012476827e-01
1.051453680104097177e-01
1.029641449661450464e-01
1.063469025113071009e-01
1.690859441285803288e-01
1.527410693669496999e-01
1.404076830217775296e-01
1.439664087998348274e-01
