1.628902230722208688e-01
1.449523916068886087e-01
1.641311782545276932e-01
1.908397059887647629e-01
1.260917987840782239e-01
1.347087242174893618e-01
1.331049944274127483e-01
6.453865294211677539e-02
1.857886095531284809e-01
1.719267150121075727e-01
1.687448065994041346e-01
1.578894652692335032e-01
1.394537764800978519e-01
1.445749822471822932e-01
1.108280621868159149e-01
9.286759421229362488e-02
