1.455435380960504177e-01
1.420228370864476397e-01
1.518149490335158058e-01
1.441785957265113161e-01
1.316890782743160293e-01
1.747468171109046176e-01
1.605002498254179955e-01
1.552129926359546996e-01
1.576640180511666156e-01
1.696987942060721732e-01
1.788237471399562739e-01
1.494854008113699340e-01
1.690038853724087908e-01
1.914526612963527441e-01
1.466981055481093310e-01
1.812742758941437438e-01
