1.917763745412230381e-01
1.725681734138301560e-01
1.864567948837897726e-01
2.172209626462842658e-01
1.512959151794867896e-01
1.598561264441481777e-01
1.598925854611609743e-01
7.865087661359991544e-02
2.199329882194953345e-01
2.044110918151480771e-01
1.976823561292673781e-01
1.841081382174576953e-01
1.661793254981083490e-01
1.720959628666085817e-01
1.337995654238121890e-01
1.164738311033163692e-01
