1.977191227326329792e-01
1.817885461719746243e-01
2.080224861274331261e-01
2.471672571760531734e-01
7.461519399427832266e-02
1.439357598186299103e-01
2.266582548940256070e-01
1.893608280081804929e-01
1.359179698583423967e-01
1.130912690398397646e-01
1.732942255296160972e-01
1.590954508433384262e-01
1.604572381522757496e-01
2.058187863574890419e-01
2.071116164674354498e-01
2.178806221503951368e-01
