2.600818848791277560e-01
1.528897208221288995e-01
2.572947502915923224e-01
3.321918053552508354e-01
1.365055626582066528e-01
1.603038008127271041e-01
2.895070096336504473e-01
1.981978845735739014e-01
2.448295126991979487e-01
1.257778568334677882e-01
2.006654223187069874e-01
1.735868103257546813e-01
1.809995960740187482e-01
1.742876931702994625e-01
1.599246878010620043e-01
1.730111940232745837e-01
