1.992501398906045273e-01
2.350740364054217935e-01
1.431528721534829907e-01
1.649020332879445050e-01
7.987372913824704324e-02
3.039009605223934041e-01
1.580347075858818673e-01
1.523539000523409792e-01
1.409331710019614547e-01
1.457565701851611661e-01
1.502889345449927583e-01
1.587034720994000003e-01
2.713672304525971413e-01
1.546186621708329767e-01
1.354886760403002932e-01
1.176982089902074702e-01
