1.969138095582214365e-01
1.109007198292601970e-01
1.978141166535871409e-01
1.768975542716881566e-01
1.057987702523267431e-01
2.447501711150315284e-01
1.874575448611202344e-01
2.132611410159890031e-01
1.213703684363005297e-01
1.517459518010062791e-01
2.784152613541144849e-01
2.734298242389091582e-01
2.231318416525027715e-01
2.102190234017403403e-01
1.881122621541310713e-01
1.538018927489507026e-01
