1.954831357890119137e-01
1.417293164080807022e-01
1.484481635104332731e-01
1.660002452055258371e-01
1.170021639076627012e-01
1.887027713071022794e-01
1.642263502747352555e-01
2.149188319620277121e-01
1.608331816636824063e-01
1.958605853973754696e-01
1.614231284308646486e-01
2.251565110470567510e-01
1.990287533761667393e-01
2.148739680040827327e-01
2.238506329553534291e-01
2.554040223227015405e-01
